;fcitx Version 0x03 Table file
KeyCode=abcdefghijklmnopqrstuvwxyz;
Length=4
Pinyin=@
PinyinLength=4
Prompt=&
ConstructPhrase=^
[Rule]
e2=p11+p12+p21+p22
e3=p11+p21+p31+p32
a4=p11+p21+p31+n11
[Data]
a	啊
a	按
aa	阿
aae	阿
aaek	阿
aaj	锕
aajk	锕
aak	吖
aakk	啊
aakw	嗄
aaky	吖
aao	腌
aaod	腌
ah	昂
aho	肮
ahoe	昂
ahoj	肮
ahp	卬
ahpe	卬
ahy	盎
ahym	盎
ai	爱
aib	癌
aibe	癌
aibj	皑
aic	艾
aicv	蔼
aicx	艾
aie	隘
aiej	𬮿
aiem	隘
aiey	叆
aif	挨
aift	捱
aij	锿
aijy	锿
aik	唉
aikm	嗌
aikx	哎
aiky	嗳
ain	嫒
ainy	嫒
aio	暧
aioy	暧
aip	爱
aipy	爱
ais	欸
aisr	欸
ait	埃
aitu	埃
aitv	堨
aiu	矮
aiuc	碍
aiun	矮
aiuw	毐
aiux	砹
aiw	哀
aiwy	瑷
aiy	霭
aiyv	霭
an	安
ana	𩽾
anb	案
anbn	安
and	鹌
andn	鹌
ane	岸
aneg	岸
anf	按
anfn	按
ang	庵
angd	庵
angn	鞍
anh	黯
anho	黯
anj	铵
ank	唵
ankd	唵
anm	桉
anmn	桉
ano	暗
anon	胺
anoo	暗
anq	氨
anqg	犴
anqn	氨
anr	俺
anrd	俺
anrm	盦
ant	埯
antn	垵
any	谙
anyo	谙
ao	奥
aoa	奡
aoal	奡
aob	翱
aobx	翱
aod	澳
aodd	澳
aoe	隩
aoed	隩
aof	熬
aofa	鳌
aofe	聱
aofh	熬
aofi	螯
aofj	鏊
aofl	拗
aofm	骜
aofq	獒
aofw	敖
aog	鏖
aogj	鏖
aogw	廒
aok	嗷
aokw	嗷
aol	凹
aola	凹
aon	媪
aonm	媪
aop	袄
aopd	奥
aopy	袄
aor	傲
aorw	傲
aot	坳
aotl	坳
aow	璈
aoww	璈
aox	懊
aoxd	懊
aoy	岙
aoz	遨
aozw	遨
b	不
b	吧
ba	把
baa	鲅
baab	鲃
baad	鲅
bab	爸
babb	疤
bac	芭
bacb	芭
bacd	菝
bad	灞
bado	灞
bae	岜
baeb	岜
baf	拔
bafb	扒
bafd	捌
bag	靶
bagb	靶
bagd	魃
baib	蚆
baj	钯
bajb	钯
bak	吧
bakb	叭
bakz	哱
bal	耙
bam	粑
bamb	朳
ban	妭
band	妭
bao	胈
baod	胈
bap	八
bapn	八
bas	罢
basl	巴
bass	罢
bat	坝
batr	坝
bav	巴
bavb	笆
bavv	巴
bay	霸
bayb	羓
bayo	霸
baz	跋
bazd	跋
bb	滨
bba	鬓
bbab	鬓
bbb	宾
bbbb	宾
bbbe	邠
bbd	濒
bbdb	殡
bbdr	濒
bbe	豳
bbeu	豳
bbf	摈
bbfb	摈
bbg	髌
bbgb	髌
bbj	镔
bbjb	镔
bbm	彬
bbmb	槟
bbmp	彬
bbo	膑
bbob	膑
bbr	傧
bbrb	傧
bbs	缤
bbsb	缤
bbw	斌
bbwd	玢
bbwv	斌
bc	报
bc	宝
bca	鲍
bcas	鲍
bcb	包
bcb	鸨
bcbd	刨
bcbs	包
bcby	宝
bcc	薄
bccc	薄
bccm	葆
bccs	苞
bcd	瀑
bcf	抱
bcfs	抱
bch	爆
bchs	炮
bcms	枹
bco	暴
bcos	胞
bcou	曝
bcp	褓
bcpm	褓
bcr	保
bcrh	煲
bcrm	保
bcrt	堡
bcu	饱
bcus	饱
bcv	豹
bcv	龅
bcvd	剥
bcw	褒
bcwy	褒
bcy	雹
bcys	雹
bcz	趵
bczs	孢
bd	白
bda	百
bdab	百
bdf	摆
bdfs	摆
bdfu	捭
bdh	稗
bdk	败
bdkr	呗
bdkw	败
bdm	柏
bdmb	柏
bdpo	白
bdr	佰
bdrb	伯
bdu	拜
bduf	拜
bduu	掰
bf	本
bf	笨
bfa	本
bfaa	本
bfb	坌
bfbt	坌
bfc	苯
bfcb	苯
bfd	奔
bfdc	奔
bfj	锛
bfjc	锛
bfm	栟
bfn	犇
bfrc	倴
bfs	畚
bftd	坋
bfu	贲
bfur	贲
bfv	笨
bg	蹦
bg	甭
bgb	甭
bgby	甭
bge	崩
bgeo	崩
bgi	蚌
bgif	蚌
bgjo	镚
bgk	嘣
bgko	嘣
bgpf	祊
bgs	绷
bgso	绷
bgt	堋
bgto	堋
bgu	泵
bguu	泵
bguw	甏
bgw	琫
bgwl	琫
bgz	迸
bgzk	迸
bgzo	蹦
bh	帮
bhc	蒡
bhcf	蒡
bhd	浜
bhdb	浜
bhf	邦
bhfe	邦
bhff	搒
bhfj	帮
bhi	蚌
bhj	镑
bhjf	镑
bhk	𠳐
bhm	棒
bhme	梆
bhmf	榜
bhmk	棓
bho	膀
bhof	膀
bhr	傍
bhs	绑
bhse	绑
bht	塝
bhtf	塝
bhu	磅
bhuf	磅
bhup	彭
bhw	玤
bhwf	玤
bhy	谤
bhyf	谤
bi	比
bi	逼
bia	鲾
biat	鲾
bib	毙
bibb	毖
bibe	邲
bibl	痹
bibt	坒
bibu	毕
bic	蔽
bic	薜
bicb	蓖
bicu	荜
bicw	蔽
bicz	荸
bid	必
bidb	泌
bidc	弊
bidd	必
bidl	濞
bidm	滗
bidw	敝
bie	陛
biet	陛
big	庇
bigg	弼
bigu	髀
bih	秕
bihb	秘
bii	彼
biiy	彼
bij	铋
bik	哔
bikb	吡
bike	鄙
bikr	赑
biku	哔
bim	闭
bin	婢
binb	妣
binu	婢
bio	睥
biou	睥
bip	币
bipj	币
bipu	裨
bipv	匕
biq	狴
biqt	狴
bir	俾
birb	佖
bis	纰
bisb	纰
bit	畀
bitl	畀
biu	壁
biu	璧
biub	屄
biun	嬖
biuo	臂
biur	贲
biut	壁
biuu	辟
biv	笔
bivb	篦
bivm	笔
bivu	筚
biw	碧
biwb	珌
biwy	觱
bix	愎
bixy	觱
biy	诐
biz	避
bizl	鼻
bizt	逼
bj	办
bjb	颁
bjbr	颁
bjbw	癍
bjby	瘢
bjd	半
bjdy	湴
bje	阪
bjf	搬
bjfb	拌
bjfd	扮
bjfy	扳
bjgb	靽
bjjy	钣
bjl	瓣
bjld	办
bjm	板
bjmb	柈
bjoy	昄
bjp	版
bjpy	版
bjr	伴
bjrb	伴
bjs	绊
bjsb	绊
bjt	坂
bjv	般
bjw	班
bjww	斑
bk	并
bka	丙
bkan	丙
bkb	病
bkbb	病
bkbe	邴
bkbk	并
bkd	冰
bkf	摒
bkfk	摒
bkh	炳
bkhb	炳
bki	蛃
bkib	蛃
bkm	柄
bkm	槟
bko	昺
bkob	昺
bkp	秉
bkpn	秉
bkq	兵
bkqb	兵
bku	饼
bkuk	屏
bkw	禀
bkwx	禀
bm	边
bma	鳊
bmac	鳊
bmc	苄
bmcb	苄
bmcc	萹
bmd	汴
bmdb	汴
bmdx	卞
bmf	抃
bmfb	抃
bmg	鞭
bmh	扁
bmh	煸
bmic	蝙
bmk	贬
bmkc	匾
bmkf	贬
bml	辩
bml	辫
bmlu	辨
bmo	昪
bmoc	昪
bmp	褊
bmr	便
bmrg	便
bms	编
bmsc	弁
bmu	砭
bmuc	碥
bmw	变
bmwy	变
bmx	忭
bmz	遍
bmzl	边
bn	表
bna	鳔
bnax	鳔
bnb	瘭
bnbx	瘭
bnc	蔈
bnch	藨
bncx	蔈
bndh	瀌
bnfx	摽
bnfy	表
bnh	彪
bnhp	彪
bnhx	熛
bnj	镖
bnjh	镳
bnjs	飑
bnm	标
bnmu	杓
bnmx	骠
bnn	婊
bno	膘
bnox	膘
bnoy	脿
bnp	裱
bnpy	裱
bnq	飙
bnqx	飙
bnr	俵
bnrh	儦
bnry	俵
bo	拨
boa	鲌
boab	鲌
boar	僰
bob	帛
bobj	帛
boc	薄
bocc	薄
boct	蕃
bocy	菠
bod	波
bodb	泊
bodl	渤
body	波
boe	嶓
boet	嶓
bof	播
bofc	搏
bofd	拨
boft	播
boh	馞
bohz	馞
boj	铂
bojb	钵
bojc	镈
bojd	钹
bojy	𬭛
bok	啵
boky	啵
bokz	哱
bol	卜
bold	卜
bom	柏
bomb	柏
bomc	榑
bomx	驳
bomz	桲
boo	膊
booc	膊
booz	脖
bopd	袯
bor	伯
borb	伯
bou	博
boub	砵
bouc	礴
boul	勃
boum	檗
boun	鹁
bout	磻
bouu	擘
bouz	饽
bov	剥
bov	箔
bovb	舶
bovc	簿
bovd	剥
bovy	簸
bow	玻
bowq	亳
bowy	玻
boz	跛
bozk	踣
bozy	跛
bp	别
bpb	瘪
bpbb	瘪
bpd	憋
bpda	鳖
bpdr	蹩
bpdx	憋
bpk	别
bpkd	别
bu	部
bua	不
buad	不
buc	蔀
buf	捕
bufn	𬷕
buj	钚
buk	哺
bukb	卟
bul	卜
buo	晡
buof	晡
bup	补
bur	堡
burt	堡
but	埠
butf	埔
buu	布
buv	步
buvc	簿
buvp	步
bux	怖
buxj	怖
buy	醭
buyn	醭
buz	逋
buzf	逋
bw	被
bw	背
bwc	蓓
bwck	蓓
bwe	陂
bwey	陂
bwf	悲
bwfi	辈
bwfx	悲
bwgu	庳
bwgy	鞴
bwh	焙
bwhk	焙
bwj	钡
bwjr	钡
bwk	呗
bwkr	贝
bwl	北
bwlb	北
bwlo	背
bwm	杯
bwmb	杯
bwmu	椑
bwmy	糒
bwp	卑
bwpn	鹎
bwpu	卑
bwpy	被
bwq	狈
bwqr	狈
bwr	倍
bwrk	倍
bwu	碑
bwuj	鐾
bwuk	碚
bwul	勃
bwuo	臂
bww	备
bwwt	备
bwwx	惫
bwx	悖
c	才
c	此
ca	擦
caf	拆
cafi	拆
cafx	擦
cak	嚓
cakx	嚓
cc	草
cca	曹
ccao	曹
cccu	草
ccd	漕
ccdo	漕
ccf	操
ccfm	操
cci	螬
ccio	螬
cck	嘈
ccko	嘈
ccm	槽
ccmo	槽
ccmz	糙
ccr	肏
ccrr	肏
ccuo	𥕢
ccv	艚
ccvo	艚
cd	菜
cd	猜
cda	才
cdap	才
cdc	蔡
cdcm	菜
cdcx	蔡
cdk	财
cdkc	财
cdm	材
cdo	睬
cdom	睬
cdp	采
cdpm	采
cdpp	彩
cdq	猜
cdqo	猜
cdu	裁
cduy	裁
cdz	踩
cdzm	踩
ce	测
ced	测
cedd	测
cei	厕
ceid	厕
cem	栅
cemc	栅
cep	册
cepa	册
cer	侧
cerd	侧
cev	策
cevn	策
cex	恻
cexd	恻
cf	岑
cfd	涔
cfdv	涔
cfe	岑
cfev	岑
cfs	参
cfsp	参
cg	曾
cgb	曾
cgbo	曾
cge	嶒
cgeo	嶒
cgk	噌
cgko	噌
cgu	层
cgus	层
cgz	蹭
cgzo	蹭
ch	藏
chc	苍
chci	藏
chd	沧
chdv	沧
chr	仓
chrn	鸧
chrv	伧
chv	舱
chvv	舱
chw	玱
chwv	玱
ci	次
cia	刺
ciad	刺
cib	慈
cibb	疵
cibn	鹚
cibx	慈
ciby	兹
cic	茨
cicb	茈
cicd	莿
cicr	茨
cid	瓷
cidb	泚
cidr	次
cidw	瓷
cik	赐
cikb	呲
cikw	赐
cim	糍
cimy	糍
cip	祠
ciq	辞
cir	伺
cirk	伺
cirr	佽
ciu	磁
ciuy	磁
civ	此
civa	𫚖
civb	此
civf	雌
ciwb	玼
ciy	词
ciyg	差
ciz	跐
cizb	跐
cj	参
cjd	残
cjf	掺
cjfp	掺
cjh	灿
cjhe	灿
cjhp	黪
cjl	餐
cjll	餐
cjlm	粲
cjm	骖
cjmp	骖
cjsp	参
cjt	蚕
cjti	蚕
cju	孱
cjuz	孱
cjw	璨
cjwm	璨
cjx	惨
cjxj	惭
cjxp	惨
co	错
cob	痤
cobg	瘥
cobt	痤
coc	莝
coct	莝
coe	嵯
coeg	嵯
cof	搓
cofg	搓
cofo	措
coft	挫
cofy	撮
coi	厝
coio	厝
coj	锉
cojo	错
col	鹾
colg	鹾
con	酂
cone	酂
coo	脞
coot	脞
cou	矬
coug	磋
cout	矬
cowg	瑳
coz	蹉
cozg	蹉
cr	窜
crb	窜
crbi	窜
crf	攒
crfi	撺
crfr	攒
crj	镩
crji	镩
crp	爨
crph	爨
crr	汆
crv	篡
crvs	篡
crz	蹿
crzi	蹿
cs	从
csb	匆
csbd	匆
csc	葱
cscr	苁
cscx	葱
csd	淙
csdx	淙
cse	聪
csex	聪
csh	熜
csm	骢
csmr	枞
csmx	骢
csp	囱
cspw	囱
csr	丛
csra	丛
csrr	从
csw	琮
cswx	璁
csx	悰
csxx	悰
cu	粗
cua	蹙
cuar	蹙
cuc	蔟
cud	殂
cudq	殂
cui	徂
cuiq	徂
cum	粗
cumq	粗
cuq	猝
cuqu	猝
cur	促
curr	促
cuv	簇
cuvu	簇
cuw	蹙
cuwr	蹙
cuwu	卒
cuy	醋
cuyo	醋
cuyv	酢
cuz	蹴
cuzy	蹴
cv	催
cvb	瘁
cvbu	瘁
cvc	萃
cvd	淬
cvdf	漼
cvdu	淬
cve	崔
cvef	崔
cveu	崒
cvf	摧
cvff	摧
cvk	啐
cvku	啐
cvm	粹
cvmu	粹
cvmy	榱
cvo	脆
cvov	脆
cvr	催
cvrf	催
cvs	缞
cvsy	缞
cvw	璀
cvwf	璀
cvwy	衰
cvx	翠
cvxu	悴
cy	村
cya	寸
cyad	寸
cym	村
cymc	村
cys	皴
cysy	皴
cyt	邨
cyte	邨
cyu	存
cyuz	存
cyx	忖
cyxc	忖
cz	凑
czdt	凑
czi	辏
czit	辏
czo	腠
czot	腠
d	的
d	打
da	大
da	搭
dab	瘩
dac	荙
dacz	荙
dad	耷
dade	耷
dadk	溚
daf	打
dafd	打
dafk	搭
dag	鞑
dag	靼
dah	炟
dajz	𫟼
dak	哒
dakk	嗒
dan	妲
dand	妲
dap	褡
dau	沓
daun	大
dauo	沓
dav	答
davd	笪
davk	答
dax	惮
daxd	怛
daz	达
dazz	跶
dc	到
dc	道
dca	鱽
dcad	到
dcd	盗
dcf	捣
dcfd	捯
dcfe	捣
dcfh	焘
dcfx	纛
dch	稻
dchj	稻
dcj	帱
dcjc	帱
dck	叨
dckd	叨
dcm	梼
dcmc	梼
dcp	岛
dcpc	祷
dcpe	岛
dcq	氘
dcr	倒
dcrd	倒
dcs	导
dcsc	导
dcv	刀
dcvd	舠
dcvp	刀
dcx	悼
dcxd	忉
dcxu	悼
dcz	道
dczj	蹈
dczz	道
dd	代
dda	歹
ddax	歹
ddd	殆
dde	叇
ddez	叇
ddf	带
ddfj	带
ddi	待
ddic	待
ddid	轪
ddk	呆
ddkm	呆
ddkt	呔
ddm	棣
ddmn	棣
ddr	贷
ddre	岱
ddrh	黛
ddrr	贷
ddrt	垈
ddru	傣
ddry	袋
dds	怠
ddsk	绐
ddsx	怠
ddt	埭
ddtn	埭
ddu	戴
ddub	戴
ddun	大
ddw	玳
ddwy	玳
ddy	诒
ddyk	诒
ddz	逮
ddzk	迨
ddzn	逮
de	得
debu	的
dei	德
deic	得
deix	德
dej	锝
dejc	锝
dek	嘚
dekc	嘚
det	地
dety	地
dff	扽
dfft	扽
dg	等
dgd	澄
dgda	澄
dge	嶝
dgea	嶝
dgh	灯
dghd	灯
dgja	镫
dgk	噔
dgka	噔
dgo	瞪
dgoa	瞪
dgog	戥
dgu	磴
dgua	磴
dgv	登
dgva	登
dgvj	凳
dgw	璒
dgwa	璒
dgxa	憕
dgy	邓
dgye	邓
dgz	蹬
dgza	蹬
dh	当
dhb	宕
dhbu	宕
dhc	荡
dhcp	荡
dhcu	菪
dhdy	𬍡
dhf	挡
dhfe	挡
dhj	铛
dhje	铛
dhm	档
dhme	𣗋
dhp	裆
dhpe	裆
dhte	垱
dhu	凼
dhuk	凼
dhup	砀
dhw	珰
dhwe	珰
dhx	党
dhxe	当
dhy	谠
di	地
dia	髢
diay	髢
dib	弟
dibp	弟
dic	蒂
dich	荻
dicj	蒂
dicu	菂
did	涤
dide	邸
didk	滴
dif	抵
difd	抵
difr	提
dig	底
digd	骶
digr	鞮
dij	镝
dijk	镝
dik	嘀
dikk	嘀
diku	啲
dim	棣
dimd	柢
dimn	棣
din	嫡
dinj	媂
dink	嫡
dinp	娣
dio	睇
diop	睇
diq	敌
diqh	狄
diqw	敌
dir	低
dird	低
dirm	籴
dis	缔
dit	堤
ditd	坻
ditr	堤
dity	地
diu	氐
diud	砥
diue	觌
diuj	碲
diul	䃅
diur	疐
div	第
divp	第
divy	笛
diw	帝
diwj	𤧛
dix	翟
dixf	翟
diy	谛
diyd	诋
diz	递
dizj	遆
dizk	蹢
dizp	递
dizr	踶
dizy	迪
dj	但
dja	石
djak	石
djb	单
djb	疸
djbe	郸
djbl	瘅
djc	萏
djcj	萏
djd	淡
djdl	殚
dje	耽
djer	聃
djev	耽
djf	担
djfd	担
djfl	掸
djg	弹
djk	啖
djkh	赕
djo	胆
djoa	旦
djod	膻
djov	眈
djp	丹
djpa	丹
djq	氮
djqh	氮
djr	儋
djrd	但
djrk	儋
djrl	𫢸
djs	𬘘
djsv	𬘘
djv	蛋
djvd	疍
djwd	亶
djx	惮
djxh	惔
djxk	憺
djy	诞
dk	定
dka	丁
dkal	丁
dkb	疔
dkbd	疔
dkbr	定
dkcr	萣
dkd	顶
dke	耵
dked	耵
dkj	钉
dkjd	钉
dkjr	锭
dkjz	铤
dkk	叮
dkkd	叮
dkkr	啶
dko	盯
dkod	盯
dkor	腚
dkov	鼎
dkr	仃
dkrd	仃
dkt	町
dktd	町
dku	碇
dkur	碇
dkw	玎
dkwd	玎
dky	订
dkyd	酊
dm	点
dmb	癫
dmbd	奠
dmbr	癫
dmbt	甸
dmby	癜
dmd	滇
dmdb	滇
dmdr	淀
dme	巅
dmek	阽
dmer	巅
dmf	垫
dmfk	掂
dmfr	靛
dmft	垫
dmg	店
dmgk	店
dmh	扂
dmhk	扂
dmj	钿
dmjt	钿
dml	电
dmlb	典
dmlh	点
dmlv	电
dmr	佃
dmrt	佃
dmtk	坫
dmu	殿
dmub	碘
dmur	颠
dmv	簟
dmw	玷
dmwk	玷
dmwr	琔
dmx	惦
dmz	踮
dmzk	踮
dn	调
dna	鲷
dnak	鲷
dnb	窎
dnbn	窎
dnd	凋
dnf	掉
dnfu	掉
dnj	钓
dnjd	铫
dnjj	铞
dnju	钓
dnk	吊
dnkd	叼
dnkf	雕
dnkj	吊
dnmk	椆
dnp	鸟
dnpa	鸟
dnu	屌
dnuk	碉
dnv	刁
dnvk	貂
dnw	鸟
dnwd	鸟
dnyk	调
do	多
dod	夺
dodc	夺
doe	堕
doeo	隋
doet	堕
doex	隳
dof	掇
dofy	掇
dog	度
dogy	度
doj	朵
dojd	剁
dojl	铎
dojz	𬭚
dok	咄
doki	咄
dokm	哚
dokx	哆
dom	驮
domb	柁
domd	杕
dop	裰
dopy	裰
dot	垛
doti	埵
dotm	垛
doty	㙍
dou	躲
doum	躲
dov	舵
dovb	舵
dowl	亸
dox	惰
doxo	惰
doyd	剟
doz	跺
dozm	跺
dozy	踱
dp	跌
dpa	鲽
dpam	鲽
dpb	爹
dpbx	爹
dpej	𫶇
dpg	瓞
dpgu	瓞
dpi	蝶
dpim	蝶
dpk	喋
dpkm	喋
dpkt	咥
dpl	耋
dplt	耋
dpmm	楪
dpo	昳
dpop	䏲
dpou	昳
dpp	牒
dpr	佚
dps	绖
dpst	绖
dpt	垤
dptm	堞
dptt	垤
dpu	碟
dpum	碟
dpy	叠
dpym	谍
dpyq	叠
dpz	迭
dpzm	蹀
dpzu	跌
dq	丢
dqj	铥
dqjs	铥
dqp	丢
dqps	丢
dr	段
dre	耑
dree	耑
drh	煅
drj	锻
drjy	锻
drl	端
drm	断
drmy	椴
drpy	段
drs	缎
drsy	缎
drty	塅
dru	短
drua	短
drv	簖
drvj	簖
drwy	瑖
ds	动
ds	冻
dsa	东
dsad	东
dsc	董
dscv	董
dsd	洞
dsdd	冻
dsdk	洞
dsdn	鸫
dse	峒
dsed	岽
dsek	峒
dsel	动
dshk	烔
dsi	𬟽
dsid	𬟽
dsk	咚
dsm	栋
dso	胴
dsod	胨
dsok	胴
dsq	氡
dsqd	氡
dsr	侗
dsrk	侗
dst	垌
dsu	硐
dsuk	硐
dsw	冬
dswd	冬
dsx	懂
dsxk	恫
dsxv	懂
du	读
dua	蠹
duct	芏
dud	渡
dudd	渎
dudy	渡
duf	毒
dufm	毒
dug	度
dugi	髑
duh	黩
duj	镀
dujy	镀
duk	赌
duke	嘟
duko	赌
dul	都
dum	杜
dumd	椟
dumt	杜
dun	妒
dund	犊
dunk	姤
duo	肚
duoo	睹
duot	肚
dup	牍
dupd	牍
duq	独
dut	堵
duto	堵
duu	督
duuo	督
duv	笃
duvm	笃
duvs	厾
duy	读
dv	对
dvb	兑
dvbe	兑
dve	队
dver	𬯎
dvj	镦
dvjw	镦
dvjz	𬭚
dvp	祋
dvpy	祋
dvt	堆
dvtf	堆
dvu	碓
dvuf	碓
dvw	敦
dvww	敦
dvy	怼
dvyc	对
dvz	追
dvzk	追
dw	得
dwi	得
dwic	得
dxk	嗲
dxkx	嗲
dy	顿
dyd	沌
dydt	沌
dyh	炖
dyht	炖
dyj	钝
dyk	吨
dykt	囤
dymo	楯
dyo	盹
dyot	盹
dyp	盾
dypo	盾
dyt	墩
dytr	顿
dytt	坉
dytw	墩
dyut	砘
dyuw	礅
dyw	敦
dywr	趸
dyxt	忳
dyxz	惇
dyz	蹲
dyzc	蹲
dyzo	遁
dz	都
dz	逗
dza	豆
dzaa	豆
dzb	痘
dzba	痘
dzbd	窦
dzbe	兜
dzc	蔸
dzce	蔸
dzd	斗
dzdu	斗
dze	陡
dzer	陡
dzf	抖
dzi	蚪
dziu	蚪
dzj	钭
dzju	钭
dzp	兜
dzpe	兜
dzv	篼
dzve	篼
dzyd	读
dzz	逗
dzza	逗
e	二
e	嗯
ee	额
eea	鳄
eeak	鳄
eeb	额
eebr	额
eec	萼
eeck	萼
eecv	苊
eecw	莪
eedw	涐
eee	峨
eeek	阿
eeew	峨
eef	扼
eefv	扼
eei	厄
eeiv	轭
eeiw	蛾
eej	锷
eejk	锷
eejw	锇
eek	呃
eeke	鄂
eekn	鹗
eekr	颚
eekv	呃
eekw	哦
eekx	𫫇
eem	阏
eemd	阏
een	娥
eenk	婀
eenw	娥
eeo	腭
eeok	腭
eer	俄
eerw	俄
eetv	堨
eeu	饿
eeuk	屙
eeuw	饿
eew	鹅
eewk	噩
eewn	鹅
eex	愕
eey	恶
eeyb	讹
eeyk	谔
eeyt	垩
eeyx	恶
eez	遏
eezv	遏
eh	鹤
ei	欸
eis	欸
eisr	欸
eiy	诶
eiyu	诶
en	恩
enc	蒽
encx	蒽
enf	摁
enfx	摁
enk	嗯
enkx	恩
er	而
era	耳
eraa	二
erae	鲕
eral	而
erd	尔
erde	洱
erdx	尔
ere	鸸
eree	陑
eren	鸸
erep	耏
erj	铒
erje	铒
erk	咡
erp	儿
erpv	儿
err	佴
erre	佴
eru	饵
erue	饵
erw	珥
erwe	珥
ery	贰
erz	迩
erzx	迩
eu	十
f	非
f	发
fa	法
fam	阀
fap	乏
fapv	乏
far	伐
farg	伐
fart	垡
fas	罚
fasd	罚
fau	砝
faus	砝
fav	发
favd	发
favg	筏
faw	珐
faws	珐
ff	分
ff	份
ffa	鲼
ffar	鲼
ffb	忿
ffbd	分
ffbx	忿
ffc	芬
ffcd	芬
ffcm	棻
ffd	奋
ffd	汾
ffdb	瀵
ffdt	奋
ffj	鼢
ffjd	鼢
ffk	吩
ffm	粉
ffmb	粪
ffmd	棼
ffmh	焚
ffq	氛
ffqd	氛
ffr	份
ffrd	份
ffs	纷
fft	坟
fftd	坋
fftw	坟
ffur	豮
ffw	玢
ffx	愤
ffxd	翂
ffxr	愤
ffy	酚
ffyd	酚
fg	风
fg	疯
fga	丰
fgal	丰
fgb	疯
fgbx	疯
fgc	葑
fgcc	葑
fgd	冯
fgdf	沣
fgdx	沨
fge	峰
fgec	崶
fgee	酆
fgef	峰
fgf	奉
fgfe	酆
fgfl	奉
fgh	烽
fghf	烽
fgi	蜂
fgj	锋
fgjf	锋
fgjx	风
fgjy	凤
fgk	唪
fgko	赗
fgm	枫
fgmx	枫
fgr	俸
fgrl	俸
fgs	缝
fgsz	缝
fgt	封
fgtc	封
fgtt	堼
fgu	砜
fgux	砜
fgy	讽
fgyx	讽
fgz	逢
fgzf	逢
fh	放
fha	鲂
fhaf	鲂
fhc	芳
fhcf	芳
fhd	方
fhdw	方
fhe	防
fhef	防
fhf	邡
fhfe	邡
fhh	房
fhhf	房
fhi	彷
fhj	钫
fhjf	钫
fhm	枋
fhn	妨
fhnf	牥
fho	肪
fhof	昉
fhr	仿
fhs	纺
fhsf	纺
fht	坊
fhtf	坊
fhv	舫
fhy	访
fj	反
fjc	范
fjct	藩
fjct	蕃
fjcv	范
fjcx	蘩
fjd	泛
fjdf	泛
fjh	烦
fjht	燔
fjj	凡
fjj	钒
fjjd	凡
fjjf	帆
fjjt	幡
fjk	贩
fjm	樊
fjm	梵
fjp	翻
fjpt	番
fjpx	繁
fjpy	反
fjq	犯
fjqv	犯
fjt	畈
fjtt	墦
fjty	畈
fju	饭
fju	矾
fjuy	饭
fjw	璠
fjwt	璠
fjz	返
fjzt	蹯
fjzy	返
fo	佛
for	佛
forf	佛
fu	副
fu	复
fua	夫
fuac	鲋
fuad	甫
fub	富
fuba	釜
fubb	宓
fubj	斧
fubt	匐
fubx	父
fuc	芙
fucb	芣
fucc	苻
fucf	芙
fucl	芾
fucq	茯
fucy	菔
fucz	莩
fud	负
fuda	滏
fudk	涪
fudq	洑
fudr	负
fudx	㳇
fudz	浮
fue	附
fuec	附
fuer	𫖯
fuf	扶
fuf	敷
fufb	艴
fufc	拊
fuff	拂
fuff	麸
fufw	抚
fug	府
fugc	府
fuge	鄜
fugr	腐
fuh	馥
fuhw	馥
fuhz	稃
fui	辅
fui	蜉
fuif	蚨
fuit	辐
fuit	蝠
fuiw	蝮
fuj	幅
fujn	幞
fujt	幅
fuk	赋
fukc	咐
fukc	赙
fukf	呋
fukw	呒
ful	孵
fulz	孵
fum	驸
fumc	榑
fumz	桴
fun	妇
fune	妇
fuo	服
fuo	脯
fuoc	腑
fuof	肤
fuow	腹
fuoy	服
fup	福
fupd	祓
fupe	郛
fupj	凫
fupq	袱
fupt	福
fupu	阜
fupw	复
fupz	孚
fuq	氟
fuqf	氟
fur	付
fur	俯
furc	傅
furf	佛
furq	伏
furz	俘
fus	缚
fusb	罘
fusc	缚
fusd	绂
fusf	绋
fut	赴
futb	赴
fuu	砆
fuv	符
fuv	弗
fuvc	符
fuvm	簠
fuwd	韨
fuwf	玞
fuwz	琈
fux	覆
fuxf	怫
fuxw	覆
fuy	讣
fuyd	黻
fuyf	黼
fuz	跗
fuzf	趺
fw	费
fwa	鲱
fwaf	鲱
fwb	痱
fwc	菲
fwcf	菲
fwcl	芾
fwd	沸
fwdb	淝
fwdf	沸
fwf	斐
fwfd	剕
fwfi	蜚
fwfm	棐
fwfr	费
fwfw	斐
fwfx	翡
fwg	废
fwgd	废
fwh	扉
fwhf	扉
fwj	镄
fwjr	镄
fwk	匪
fwkf	啡
fwkq	吠
fwla	非
fwm	榧
fwmf	𬴂
fwn	妃
fwo	肥
fwob	肥
fwof	腓
fwoi	朏
fwol	肺
fwq	狒
fwqf	狒
fws	绯
fwsf	绯
fwv	飞
fwvd	飞
fwvf	篚
fwx	悱
fwxf	悱
fwy	诽
fwyf	霏
fz	否
fzb	否
fzbk	否
fzw	缶
fzwk	缶
g	个
g	管
ga	嘎
gaa	夹
gaag	戛
gaan	夹
gai	轧
gaiv	轧
gaj	旮
gajo	旮
gajv	钆
gak	噶
gakg	嘎
gakk	咖
gakv	噶
gan	尕
ganx	尕
gao	胳
gaok	胳
gar	伽
gark	伽
gau	尬
gaul	尬
gax	尜
gaxx	尜
gay	尬
gayl	尬
gc	高
gc	搞
gcb	皋
gcbu	皋
gcc	藁
gccm	藁
gcf	搞
gcfk	搞
gch	稿
gchk	稿
gcj	镐
gcjk	锆
gcm	糕
gcm	槁
gcmh	糕
gcmu	槔
gcn	告
gcne	郜
gcnk	告
gco	杲
gcom	杲
gcp	睾
gcpg	睾
gcsk	缟
gcv	篙
gcvk	筶
gcw	膏
gcwk	高
gcwo	膏
gcy	羔
gcyk	诰
gd	该
gd	钙
gda	丐
gdav	丐
gdc	荄
gdcr	荄
gdd	溉
gddv	溉
gde	陔
gdej	𬮿
gder	陔
gdj	改
gdjg	钙
gdjw	改
gdk	赅
gdkr	赅
gdm	概
gdmv	概
gdn	戤
gdng	戤
gdo	晐
gdor	晐
gdt	垓
gdtr	垓
gdy	盖
gdyr	该
ge	各
ge	哥
gea	戈
gead	戈
geal	鬲
geb	割
gebd	割
gebq	疙
gec	葛
gecv	葛
ged	歌
gedk	哥
gedl	滆
gee	隔
geel	隔
gef	搁
gefk	搁
geg	骼
gegk	骼
gei	蛤
geik	蛤
geiq	虼
gej	铬
gejk	铬
gejl	镉
gek	嗝
gekk	咯
gekl	嗝
gel	哿
gelk	哿
gem	格
gem	阁
gen	革
genl	革
geo	胳
geok	胳
geol	膈
gep	袼
gepk	袼
ger	鸽
gerk	合
gerl	个
gern	鸽
gerq	仡
gerr	颌
ges	纥
gesq	纥
get	圪
getl	塥
getq	圪
geu	硌
geuk	硌
gev	舸
gevk	舸
gewk	各
gey	盖
geym	盖
gf	跟
gfa	亘
gfad	亘
gfc	茛
gfcg	茛
gfe	艮
gfen	艮
gfk	哏
gfkg	哏
gfm	根
gfmg	根
gfv	艮
gfvn	艮
gfzg	跟
gg	更
gga	鲠
ggag	鲠
ggan	更
ggd	浭
ggdg	浭
gge	耿
ggeh	耿
ggg	庚
gggn	鹒
gggr	赓
ggk	哽
ggkg	哽
ggl	耕
gglj	耕
ggm	梗
ggmg	梗
ggs	绠
ggsg	绠
ggt	埂
ggtg	埂
ggu	𬒔
gguo	𬒔
ggv	颈
ggvr	颈
ggy	羹
ggyd	羹
gh	刚
ghd	港
ghdg	冮
ghds	港
ghe	岗
ghex	岗
ghf	缸
ghfg	扛
ghj	钢
ghk	冈
ghkd	刚
ghkx	冈
ghl	戆
ghlx	戆
ghm	杠
ghmg	杠
ghmx	㭎
gho	肛
ghog	肛
ghs	纲
ghsv	罡
ghsx	纲
ghtv	堽
ghu	矼
ghug	矼
ghv	筻
gj	干
gja	甘
gjaa	甘
gjau	干
gjax	鳡
gjb	疳
gjc	苷
gjcg	苷
gjd	淦
gjdg	泔
gjdw	澉
gjf	擀
gjfg	擀
gjh	秆
gjhg	秆
gjkg	咁
gjl	赣
gjlr	赣
gjm	杆
gjmg	柑
gjmw	橄
gjn	甘
gjna	甘
gjo	肝
gjog	旰
gjs	绀
gjsg	绀
gjt	赶
gjtg	坩
gju	尴
gjug	矸
gjum	尴
gjv	敢
gjvg	竿
gjvr	𬕂
gjw	感
gjwg	玕
gjwx	感
gjx	感
gjxx	感
gjy	酐
gjyg	酐
gjym	尴
gk	怪
gkf	拐
gkfl	拐
gkq	乖
gkqb	乖
gkv	夬
gkvn	夬
gkxt	怪
gl	光
gld	广
gldb	潢
gldi	广
gldw	洸
gliw	𨐈
glk	咣
glkw	咣
glmw	桄
glo	胱
glow	胱
glq	犷
glqg	犷
gltw	垙
glw	广
glwp	广
glxw	光
glz	逛
glzw	逛
go	过
gob	馘
godn	涡
gody	𬇹
goe	聒
goek	聒
goez	崞
gof	掴
gofy	掴
goi	蜾
goiy	蝈
goj	锅
gojy	帼
gok	国
gokn	呙
goky	国
gol	果
goln	果
gomg	粿
gomz	椁
goo	腘
gooy	腘
gop	虢
gopj	虢
got	埚
gotn	埚
gow	郭
gowe	郭
gowy	裹
gr	关
gr	官
gra	鳏
grad	鳏
grak	鳤
grb	官
grbc	冠
grbt	关
grc	莞
grcc	蒄
grcn	鹳
grd	灌
grdf	灌
grdk	涫
grf	罐
grfr	掼
grh	爟
grhf	爟
grm	棺
grp	盥
grpg	祼
grpm	盥
grr	倌
grrk	倌
grs	纶
grsb	纶
grsv	矜
gru	馆
gruk	馆
grv	管
grva	毌
grvk	管
grvr	贯
grwf	瓘
grwk	琯
grx	惯
grxr	惯
gry	观
grye	观
gs	共
gsa	工
gsaa	工
gsb	公
gsbk	宫
gsbs	公
gsc	恭
gscb	共
gscx	恭
gsd	觥
gsdw	觥
gsf	拱
gsfb	拱
gsg	贡
gsg	汞
gsgf	巩
gsgl	功
gsgw	攻
gsi	蚣
gsis	蚣
gsk	唝
gsl	龚
gso	肱
gsos	肱
gsr	供
gsrb	供
gsu	躬
gsv	弓
gsvr	𬕂
gsvv	弓
gsw	珙
gswb	珙
gu	古
gu	故
gua	鲴
guak	鲴
gub	谷
gubk	痼
guc	菇
gucg	菰
guck	菇
guco	蓇
gud	沽
gudo	汩
gudy	瀔
gue	崮
guek	崮
gug	鹘
gugn	鹘
guh	雇
guhf	雇
gui	顾
guik	轱
guim	蛊
guir	顾
guj	钴
gujk	锢
guk	固
gukg	呱
gukk	咕
gul	骨
gulo	骨
gum	梏
gumk	梏
gun	姑
gunk	牯
guo	股
guok	𦙶
guoy	臌
gur	估
gurk	估
gus	罟
gusk	罟
gutk	堌
guu	鼓
guuk	古
guun	鸪
guuo	瞽
guuu	辜
guuw	故
guuy	毂
guv	箍
guvj	箍
gux	贾
guy	诂
guyk	酤
guyy	羖
guz	孤
guzg	孤
gv	贵
gva	鲑
gvar	鳜
gvat	鲑
gvb	皈
gvbj	宄
gvby	皈
gvd	龟
gvdj	氿
gve	刿
gved	刿
gvev	嶲
gvf	规
gvfe	规
gvfl	鬶
gvg	庋
gvi	轨
gvij	轨
gvk	匦
gvkj	匦
gvkr	匮
gvl	归
gvm	桂
gvmj	柜
gvms	桧
gvmt	闺
gvn	妫
gvnw	妫
gvo	晷
gvoh	炅
gvok	晷
gvot	眭
gvp	鬼
gvps	鬼
gvr	刽
gvrd	刽
gvre	郐
gvrg	傀
gvt	圭
gvte	邽
gvtt	圭
gvu	硅
gvut	硅
gvuv	硊
gvv	癸
gvvm	簋
gvvr	贵
gvvt	筀
gvw	瑰
gvwg	瑰
gvwt	珪
gvy	诡
gvz	跪
gw	给
gws	给
gwsk	给
gx	挂
gxb	寡
gxbd	寡
gxf	括
gxfk	括
gxft	挂
gxk	剐
gxkg	呱
gxkn	呙
gxm	栝
gxo	胍
gxog	胍
gxp	瓜
gxpb	褂
gxpn	瓜
gxq	刮
gxqd	刮
gxqn	鸹
gxt	卦
gxtb	卦
gxtg	坬
gxy	诖
gxyt	诖
gy	滚
gya	鲧
gyax	鲧
gydy	滚
gyi	辊
gyib	辊
gym	棍
gymb	棍
gys	绲
gysb	绲
gyu	磙
gyug	硍
gyw	衮
gywy	衮
gz	够
gza	觏
gzae	觏
gzb	勾
gzbs	勾
gzbx	够
gzc	苟
gzck	苟
gzd	沟
gzds	沟
gze	岣
gzek	岣
gzf	拘
gzfk	拘
gzg	鞲
gzgr	鞲
gzj	钩
gzje	觏
gzjs	钩
gzk	购
gzks	购
gzlk	耇
gzm	构
gzm	枸
gzms	构
gzn	媾
gznk	姤
gznr	媾
gzq	狗
gzqk	狗
gzr	佝
gzrk	佝
gzs	缑
gzsu	缑
gzt	垢
gztk	垢
gzuy	彀
gzv	篝
gzvk	笱
gzvr	篝
gzy	诟
gzyk	诟
gzz	遘
gzzr	遘
h	和
h	化
ha	哈
hai	蛤
haik	蛤
haj	铪
hajk	铪
hak	哈
hakk	哈
hc	好
hcb	皓
hcbk	皓
hcc	蒿
hccc	薅
hcck	蒿
hcd	浩
hcd	濠
hcdk	浩
hcdr	灏
hcdt	淏
hci	蚝
hcim	蚝
hcj	镐
hcjk	镐
hck	号
hcku	嚎
hckv	号
hcl	耗
hcnz	好
hco	昊
hcor	颢
hcot	昊
hcrd	侴
hct	郝
hcte	郝
hctu	壕
hcv	貉
hcvk	貉
hcw	豪
hcwe	鄗
hcwm	毫
hd	还
hdb	害
hdd	海
hddm	海
hdg	骸
hdk	嗨
hdkk	嗐
hdkm	嗨
hdkr	咳
hdm	骇
hdmr	骇
hdo	胲
hdor	胲
hdq	氦
hdqr	氦
hdw	亥
hdwr	亥
hdy	醢
hdym	醢
hdz	孩
hdzb	还
hdzr	孩
he	何
hea	翮
heax	翮
hec	荷
heck	菏
hed	河
hed	涸
hedf	隺
hedn	鹤
heg	鞨
heh	熇
hehk	和
hehm	盉
hek	喝
hek	嗬
hekk	呵
hekn	呙
hekv	喝
hekx	吓
hel	贺
helr	贺
helt	壑
hem	核
hemm	阖
hemr	阂
heo	曷
heon	鹖
heov	曷
hep	褐
hepm	禾
hepv	褐
heq	禾
heqn	禾
her	合
here	郃
herh	龢
herk	何
herm	盒
herr	颌
hes	纥
hesq	纥
het	赫
hetd	赫
hetk	垎
hetm	盍
heuk	饸
hev	貉
hevk	貉
hevq	龁
hew	劾
hewl	劾
hey	诃
hey	𬌗
hf	很
hfb	痕
hfbg	痕
hfig	很
hfkg	哏
hfq	狠
hfqg	狠
hfx	恨
hfxg	恨
hfy	𬣳
hfyg	𬣳
hg	横
hgc	蘅
hgci	蘅
hgi	衡
hgii	衡
hgin	鸻
hgk	哼
hgkl	哼
hgm	桁
hgmb	横
hgmi	桁
hgn	姮
hgng	姮
hgw	亨
hgwi	珩
hgwl	亨
hgx	恒
hgxg	恒
hh	行
hhc	巷
hhcs	巷
hhd	夯
hhdj	沆
hhdl	夯
hhi	行
hhk	吭
hhkj	吭
hhm	杭
hhmi	桁
hhs	绗
hhsi	绗
hhv	航
hhw	颃
hhwi	珩
hhwr	颃
hj	含
hjb	寒
hjbd	寒
hjbg	罕
hjc	菡
hjcg	蔊
hjck	菡
hjd	汉
hjdg	汗
hjdk	涵
hjdx	瀚
hjdy	汉
hje	崡
hjek	嵅
hjf	捍
hjfw	撖
hjfx	撼
hjg	邯
hjge	邗
hjgr	顸
hjh	焊
hjhg	焊
hjhk	焓
hji	蚶
hjig	虷
hjk	喊
hjkk	喊
hjkw	㘎
hjl	函
hjlk	函
hjm	阚
hjmw	阚
hjo	旱
hjog	旰
hjok	晗
hjon	暵
hjq	犴
hjqg	犴
hjr	颔
hjrk	含
hjrr	颔
hjtg	垾
hju	韩
hjuw	韩
hjux	翰
hjv	憨
hjvx	憨
hjwk	琀
hjx	憾
hjxg	悍
hjxx	憾
hjy	酣
hjyg	酣
hjz	鼾
hjzg	鼾
hk	坏
hkd	淮
hkdf	淮
hki	徊
hkm	槐
hkmg	槐
hkt	坏
hktb	坏
hkx	怀
hkxb	怀
hkz	踝
hkzg	踝
hl	黄
hla	鳇
hlaw	鳇
hlb	皇
hlbb	癀
hlc	荒
hlcb	黄
hlcv	荒
hld	湟
hldb	潢
hldw	滉
hle	隍
hlh	煌
hlhw	煌
hli	蝗
hlib	蟥
hliw	徨
hlj	凰
hljw	幌
hlkw	喤
hln	媓
hlnw	媓
hlo	晃
hlow	晃
hlu	磺
hlub	磺
hlv	簧
hlvb	簧
hlvw	篁
hlw	璜
hlwb	璜
hlwo	肓
hlx	慌
hlx	恍
hlxv	慌
hlxw	惶
hly	谎
hlyv	谎
hlz	遑
hlzw	遑
ho	或
hob	豁
hoc	获
hocd	劐
hocf	藿
hocq	获
hod	活
hodk	活
hodr	火
hody	濩
hoe	彟
hoey	彟
hof	攉
hoff	攉
hog	惑
hoga	或
hogx	夥
hoh	和
hohf	㸌
hohk	和
hoi	蠖
hoiy	蠖
hoj	镬
hojh	钬
hojy	镬
hok	嚯
hokf	嚯
hoky	嚄
hol	耠
holk	耠
hom	𬴃
homu	𬴃
hop	祸
hopn	祸
hor	货
horh	伙
hork	佸
horr	货
hoy	霍
hoyf	霍
hr	换
hra	鲩
hrae	鲩
hray	鬟
hrb	痪
hrbd	痪
hrbe	郇
hrbi	宦
hrby	寰
hrc	萑
hrcf	萑
hrcg	荁
hrd	涣
hrd	奂
hrde	浣
hrdg	洹
hrdx	漶
hrdy	澴
hre	峘
hreg	峘
hrf	擐
hrfd	换
hrfy	擐
hrh	焕
hrhd	焕
hri	患
hrix	患
hrj	豢
hrjy	锾
hrk	唤
hrkd	唤
hrky	圜
hrm	桓
hrmg	桓
hrn	嬛
hrny	嬛
hro	㬊
hroy	㬊
hrq	獾
hrqf	獾
hrs	缓
hrse	𬘫
hrsn	鹮
hrsy	缳
hrte	垸
hrvg	貆
hrw	环
hrwb	环
hrwq	𤩽
hry	欢
hryv	幻
hrz	还
hrzb	还
hrzk	逭
hs	红
hsb	宏
hsbb	谼
hsbk	訇
hsbs	宏
hsc	蕻
hscb	薨
hscg	荭
hsd	洪
hsd	泓
hsdb	洪
hsdf	浲
hsdn	鸿
hsg	弘
hsgs	弘
hsh	烘
hshb	烘
hsi	虹
hsig	虹
hsiy	轰
hsj	𬭎
hsjb	𫟹
hsjs	𬭎
hsk	哄
hskb	哄
hskn	吽
hskr	唝
hsl	竑
hsm	闳
hsms	闳
hssg	红
hsss	纮
hsu	硔
hsub	硔
hswg	玒
hsx	黉
hsy	讧
hsyg	讧
hu	户
hu	壶
hua	互
huaa	互
huay	鳠
huc	葫
huco	葫
hucw	芴
hud	沪
hud	斛
hudf	隺
hudg	瓠
hudh	滹
hudo	湖
hudw	浒
hudx	淴
hue	岵
huek	岵
huf	护
hug	弧
hugg	弧
hugn	鹘
huh	虎
huhb	扈
huhk	和
huho	煳
huhu	戽
hui	蝴
huih	轷
huio	蝴
huk	呼
hukh	呼
hukj	唬
hukw	囫
hukx	唿
hum	糊
humo	糊
humr	核
humu	槲
hun	鹄
hunh	嫭
hunk	姱
hunn	鹄
huny	鹱
huo	昒
huoh	昈
huow	昒
hup	乎
hupk	祜
hupl	乎
huq	狐
huqg	狐
huqo	猢
huu	胡
huun	鹕
huuy	壶
huv	笏
huvw	笏
huw	忽
huwj	琥
huwo	瑚
huwx	忽
hux	怙
huxx	惚
huy	醐
huye	鄠
huyo	醐
hv	会
hva	惠
hvax	惠
hvc	荟
hvck	茴
hvcs	荟
hvcx	蕙
hvd	汇
hvdk	洄
hve	堕
hvet	堕
hvex	隳
hvf	挥
hvfe	彗
hvfi	挥
hvfx	慧
hvg	麾
hvgg	廆
hvgm	麾
hvh	秽
hvh	烩
hvi	徽
hvik	蛔
hviw	徽
hvix	蟪
hvj	毁
hvjy	毁
hvk	回
hvkh	咴
hvkk	回
hvko	贿
hvku	喙
hvm	桧
hvms	桧
hvmx	橞
hvo	晖
hvoi	晖
hvom	晦
hvpw	袆
hvr	会
hvs	绘
hvss	绘
hvtx	恚
hvu	灰
hvuc	卉
hvw	珲
hvwi	虺
hvx	悔
hvxh	恢
hvxi	辉
hvy	讳
hvyh	诙
hvym	诲
hvyw	讳
hw	黑
hwjh	𬭶
hwk	嘿
hwkh	嘿
hwlh	黑
hx	话
hx	华
hxa	画
hxak	画
hxc	花
hxcb	花
hxd	滑
hxdt	觟
hxfu	砉
hxg	划
hxj	铧
hxk	哗
hxku	哗
hxm	桦
hxm	骅
hxnk	婳
hxq	猾
hxqg	猾
hxr	化
hxrb	化
hxru	华
hxyk	话
hy	混
hyc	荤
hyci	荤
hyd	浑
hydb	混
hydi	浑
hydo	湣
hydu	溷
hye	魂
hyeg	魂
hym	阍
hymo	阍
hyn	婚
hynb	婫
hyno	婚
hyu	昏
hyub	馄
hyuo	昏
hyw	珲
hyxo	惛
hyy	诨
hyyi	诨
hz	后
hza	鲘
hzak	鲘
hzb	瘊
hzg	骺
hzgk	骺
hzi	厚
hziz	厚
hzj	𬭤
hzju	𬭤
hzk	吼
hzkk	吼
hzku	喉
hzkv	吼
hzm	糇
hzmu	糇
hzp	后
hzpe	郈
hzpk	后
hzpt	垕
hzq	猴
hzqu	猴
hzr	候
hzru	侯
hztu	堠
hzv	篌
hzvu	篌
hzx	鲎
hzxa	鲎
hzz	逅
hzzk	齁
i	出
ia	差
iab	察
iabe	岔
iabx	察
iac	茶
iacm	茶
iacq	苴
iact	茬
iad	汊
iadi	汊
iae	嵖
iaed	嵖
iaf	插
iafm	搽
iaj	镲
iajj	锸
iak	喳
iakx	嚓
iam	查
iamd	楂
iamg	槎
iamh	梌
iami	杈
iamx	檫
ian	姹
ianq	姹
iap	衩
iapi	衩
iaq	猹
iaqd	猹
iar	侘
iarq	侘
iatq	垞
iau	碴
iaud	馇
iax	刹
iaxd	刹
iay	诧
iayd	叉
iayg	差
iayq	诧
iaz	蹅
ic	超
icd	潮
icdo	潮
icf	抄
icg	弨
icgk	弨
ich	炒
ichu	焯
icj	钞
icju	钞
ick	吵
icko	嘲
icku	吵
icl	耖
icmh	槱
ico	晁
icod	晁
ics	绰
ict	超
icu	朝
icuo	朝
icv	巢
icvd	剿
icvg	巢
icx	怊
id	拆
idb	瘥
idbg	瘥
idc	茝
idci	茝
idcl	茝
idfi	拆
idj	钗
idr	侪
idrl	侪
idv	柴
idvc	豺
idvm	柴
idw	虿
idwi	虿
idy	差
idyg	差
ie	车
ie	扯
iea	车
ieal	车
ied	澈
iedw	澈
ief	撤
iefv	扯
iei	彻
ieid	彻
ieo	㬚
ieow	㬚
iep	掣
iepu	掣
iet	坼
ieti	坼
ieu	砗
if	陈
ifb	宸
ifbh	疢
ifbn	宸
ifd	沉
ifdj	沉
ife	陈
ifed	陈
iff	抻
ifh	称
ifhv	煁
ifhx	称
ifi	辰
ifin	辰
ifk	臣
ifkb	嗔
ifkl	臣
ifm	郴
ifme	郴
ifmv	梣
ifo	晨
ifob	瞋
ifon	晨
ifp	衬
ifpc	衬
ifr	伧
ifrr	偁
ifrv	伧
ifs	𬘭
ifsm	𬘭
ift	趁
iftp	趁
ifu	碜
ifup	碜
ifv	龀
ifvb	龀
ifw	琛
ifwm	琛
ifx	尘
ifxt	尘
ifxv	忱
ify	谶
ifyj	谶
ifyv	谌
ig	成
ig	程
igbi	宬
igda	澄
igdw	澂
igf	撑
igfv	抢
iggw	庱
igh	称
ighp	秤
ighw	程
ighx	称
igi	惩
igim	盛
igit	蛏
igix	惩
igje	铛
igk	呈
igkw	呈
igl	丞
igla	丞
igm	橙
igma	橙
igmi	枨
igmt	柽
igmv	骋
igo	瞠
igoi	晟
igot	塍
igp	裎
igpw	裎
igq	乘
igqn	乘
igrr	偁
igt	城
igti	城
igtr	赪
igtw	埕
igv	承
igvn	承
igw	琤
igwi	珹
igwl	琤
igwv	成
igxa	憕
igxy	牚
igy	诚
igyw	酲
igz	逞
igzw	逞
ih	长
iha	厂
ihao	鲳
ihap	厂
ihas	鲿
ihc	苌
ihco	菖
ihcv	苌
ihdk	淌
ihi	徜
ihk	唱
ihko	唱
ihm	阊
ihmo	阊
ihn	娼
ihnj	嫦
ihno	娼
iho	肠
ihoo	昌
ihop	肠
ihpn	长
ihq	猖
ihqo	猖
ihr	偿
ihri	伥
ihro	倡
ihrs	偿
iht	场
ihtp	场
ihu	畅
ihup	畅
ihx	常
ihxb	鬯
ihxi	怅
ihxj	常
ihxk	惝
ihxs	尝
ihxw	敞
ihxy	裳
ihy	昶
ihyo	昶
ii	吃
iia	豉
iiay	豉
iib	痴
iibk	痴
iibx	瘛
iic	茌
iid	池
iidx	奓
iie	耻
iiev	耻
iif	持
iifc	持
iifd	摛
iig	弛
iigd	魑
iigy	弛
iih	炽
iihb	炽
iii	螭
iiid	螭
iik	嗤
iikb	叱
iikd	哧
iiki	嗤
iikq	吃
iim	驰
iimd	柢
iimy	驰
iin	媸
iini	媸
iio	匙
iiob	匙
iiok	眙
iiox	眵
iioy	胣
iip	斥
iipd	斥
iipj	褫
iipr	彳
iir	侈
iirk	佁
iirx	傺
iisj	𫄨
iit	赤
iitd	坻
iitn	墀
iiu	尺
iiul	饬
iiun	尺
iiuw	敕
iiux	翅
iiv	齿
iiv	蚩
iivj	篪
iivk	笞
iiw	啻
iiwk	啻
iixw	瓻
iiz	迟
iizk	踟
ij	产
ijb	单
ijbl	单
ijbn	冁
ijc	蒇
ijcr	蒇
ijd	潺
ijdd	澶
ijdt	瀍
ije	巉
ijed	巉
ijf	搀
ijfd	搀
ijfp	掺
ijg	廛
ijgk	韂
ijgt	廛
ijh	𬊤
iji	蝉
ijik	蟾
ijil	蝉
ijj	铲
ijjd	镵
ijju	镡
ijk	啴
ijkl	啴
ijle	觇
ijlp	产
ijm	阐
ijml	阐
ijmz	骣
ijn	婵
ijnl	婵
ijo	旵
ijoe	旵
ijp	禅
ijpl	禅
ijrd	儳
ijs	缠
ijsl	缠
iju	馋
ijud	馋
ijuy	羼
ijuz	孱
ijw	颤
ijwr	颤
ijx	忏
ijxq	忏
ijy	谄
ijyd	谗
ijz	躔
ijze	辿
ijzt	躔
ik	揣
ikf	搋
ikfe	揣
ikfj	搋
ikk	啜
ikky	啜
ikz	踹
ikze	踹
il	窗
ilb	疮
ilbv	疮
ilbw	窗
ilg	床
ilgm	床
ilj	幢
iljl	幢
ilk	噇
ilkl	噇
ilm	闯
ilml	橦
ilr	创
ilrd	创
ilx	怆
ilxv	怆
io	戳
iod	淖
iodu	淖
ioi	辍
ioiy	辍
iok	啜
ioky	啜
ios	绰
iosu	绰
iov	龊
iovr	龊
iox	惙
ioxg	戳
ioxy	惙
ioz	踔
iozu	逴
ir	传
irb	穿
irj	钏
irji	钏
irk	喘
irke	圌
irl	串
irll	串
irm	椽
irmu	椽
irp	川
irpl	川
irq	氚
irrv	传
irto	堾
irv	船
irvk	船
irx	舛
irxl	舛
irz	遄
irze	遄
is	冲
isb	宠
isbl	宠
isc	茺
isce	茺
isde	㳘
isdv	冲
isdx	漴
ise	崇
isex	崇
isf	舂
ish	种
isj	铳
isje	铳
isp	重
ispa	重
istk	埫
isv	虫
isvd	虫
isw	充
iswe	珫
isx	憧
isxv	忡
iu	处
iua	亍
iuad	亍
iud	触
iude	刍
iudf	雏
iudh	滁
iudr	濋
iue	除
iueh	除
iuel	亍
iuf	搐
iufk	摴
iuft	搐
iuh	黜
iuhi	黜
iui	厨
iui	蜍
iuic	厨
iuie	䢺
iuj	锄
ium	楚
iumc	橱
iume	柷
iumr	楚
iumv	樗
iumw	杵
iup	初
iupo	褚
iur	储
iuro	储
iury	俶
ius	绌
iuu	础
iuuq	矗
iuvk	出
iuvr	𬺓
iuvx	䝙
iuw	畜
iuwb	处
iuwt	畜
iux	怵
iuxr	憷
iuz	躇
iuzc	蹰
iuzo	躇
iv	吹
ive	陲
ivei	陲
ivf	捶
ivfi	捶
ivh	炊
ivhr	炊
ivj	锤
ivji	锤
ivk	吹
ivke	圌
ivkr	吹
ivm	槌
ivmf	椎
ivmi	棰
ivp	垂
ivpa	垂
ivr	倕
ivri	倕
ivx	惙
ixhr	欻
iy	纯
iya	䲠
iyao	䲠
iyc	莼
iyct	莼
iyd	淳
iydz	淳
iyf	春
iyfi	蠢
iyfo	春
iyi	唇
iyik	唇
iyio	蝽
iyjz	𬭚
iym	椿
iymo	椿
iyo	朐
iyok	朐
iyot	肫
iyst	纯
iyw	鹑
iywn	鹑
iywo	瑃
iyy	醇
iz	抽
iz	臭
izb	瘳
izbp	瘳
izfy	抽
izh	愁
izhk	稠
izj	帱
izjc	帱
izm	杻
izmc	梼
izn	婤
iznk	婤
izo	瞅
izoh	瞅
izr	仇
izrc	俦
izrj	仇
izrn	犨
izs	绸
izsk	绸
izt	畴
iztc	畤
izv	丑
izva	丑
izvc	筹
izx	惆
izxk	惆
izy	酬
izyv	酬
izz	臭
izzc	踌
izzq	臭
j	就
j	见
jb	进
jb	今
jbc	荩
jbcd	荩
jbd	津
jbda	殣
jbdo	溍
jbdy	浸
jbg	靳
jbga	廑
jbgj	靳
jbh	烬
jbhd	烬
jbi	尽
jbj	锦
jbjj	𬬱
jbk	噤
jbkx	噤
jbl	紧
jbl	巾
jblv	卺
jblx	紧
jbm	禁
jbma	槿
jbmx	禁
jbn	妗
jbna	堇
jbne	觐
jbp	斤
jbpl	斤
jbpv	衿
jbpx	襟
jbpy	祲
jbr	金
jbra	金
jbrv	今
jbry	仅
jbs	缙
jbs	矜
jbta	墐
jbu	馑
jbua	馑
jbv	劲
jbvl	筋
jbw	瑾
jbwa	瑾
jbwy	珒
jbx	慬
jbxa	慬
jby	谨
jbyo	晋
jbz	近
jbzj	进
ji	几
ji	极
jia	击
jiae	鲫
jiaj	鱾
jiak	髻
jial	鲚
jian	棘
jiax	𬶭
jib	寄
jibo	瘠
jibu	疾
jiby	寂
jic	藉
jic	蓟
jica	蕺
jicj	芨
jick	䓫
jicl	荠
jid	急
jid	奇
jidj	汲
jidl	济
jido	脊
jidw	激
jidx	漈
jidz	洎
jie	际
jie	觊
jiej	岌
jiel	𬯀
jieo	嵴
jiex	际
jif	挤
jifk	掎
jifl	挤
jify	技
jig	即
jiga	𬶨
jigd	暨
jigj	麂
jigt	堲
jigv	既
jih	稽
jih	嵇
jihb	积
jihw	稷
jihz	季
jii	辑
jiij	虮
jiik	徛
jiit	墼
jij	忌
jijt	𫓯
jik	唧
jika	戢
jikd	戢
jikj	叽
jil	冀
jila	亟
jim	机
jim	骥
jime	楫
jimj	极
jin	嫉
jini	姬
jink	犄
jinl	姬
jiny	妓
jio	肌
jioj	肌
jip	及
jip	系
jipr	𫌀
jipv	几
jipx	祭
jiq	基
jiqb	其
jiqo	期
jiqt	基
jiqx	惎
jir	集
jirk	佶
jirm	集
jirv	偈
jiry	伎
jis	级
jis	继
jisd	罽
jise	缉
jisj	纪
jisk	给
jism	羁
jisr	绩
jit	圾
jitk	畸
jiu	吉
jiu	戟
jiuj	饥
jiuj	矶
jiuk	吉
jiur	赍
jiuy	屐
jiv	己
jiv	笈
jiva	𫚖
jivb	箕
jivk	笄
jivo	籍
jiw	剂
jiw	玑
jiwd	剂
jiwl	齑
jix	悸
jixz	悸
jiy	记
jiy	计
jiyj	讥
jiyk	诘
jiyl	霁
jiyn	鸡
jiyt	畿
jiz	迹
jizl	跻
jizo	蹐
jizx	跽
jk	经
jka	井
jkal	井
jkax	鲸
jkb	痉
jkbg	痉
jkc	敬
jkc	荆
jkcg	茎
jkck	警
jkco	菁
jkcw	敬
jkd	净
jkdg	泾
jkdj	汫
jkdl	净
jke	阱
jkej	阱
jkf	静
jkfe	靓
jkfl	静
jkfn	䴖
jkfu	旌
jkgx	麖
jki	径
jkj	镜
jkje	镜
jkjo	鼱
jkl	竟
jkl	靖
jkle	竞
jkm	精
jkmg	粳
jkn	婧
jkno	婧
jko	晶
jko	腈
jkog	胫
jkoj	肼
jkoo	睛
jkox	景
jkq	獍
jkqe	獍
jkqx	猄
jkr	儆
jkrw	儆
jkrx	倞
jks	经
jksg	经
jkt	境
jkte	境
jku	兢
jkv	劲
jkvd	刭
jkvo	箐
jkvr	颈
jkw	京
jkwx	璟
jkx	惊
jkx	憬
jkz	迳
jl	将
jla	豇
jlac	鳉
jlag	豇
jlc	蒋
jlcc	蒋
jlcg	茳
jld	江
jldd	奖
jldg	江
jldl	洚
jldm	桨
jldu	浆
jldy	酱
jle	降
jlel	降
jlg	疆
jlga	疆
jlgi	强
jlgn	犟
jlgx	弶
jlk	匠
jlkj	匠
jll	耩
jllr	耩
jlm	糨
jlmi	糨
jlo	膙
jloi	膙
jlr	僵
jlra	僵
jls	缰
jlsa	缰
jlsl	绛
jlu	礓
jlua	礓
jly	讲
jlyn	姜
jm	间
jm	贱
jma	柬
jmad	戋
jman	鳒
jmat	鲣
jmb	兼
jmb	煎
jmbd	剪
jmbn	鹣
jmbr	蹇
jmbx	翦
jmc	荐
jmci	茧
jmck	菅
jmcn	蒹
jmcz	荐
jmd	减
jmd	渐
jmdd	湔
jmdj	溅
jmdo	涧
jmdq	歼
jmf	捡
jmfd	拣
jmfn	搛
jmg	鞯
jmgg	靬
jmgz	鞬
jmh	肩
jmj	键
jmjo	锏
jmjz	键
jmk	见
jmkj	贱
jml	坚
jmlj	鉴
jmlm	监
jmm	检
jmm	槛
jmme	枧
jmmz	毽
jmn	奸
jmng	奸
jmnz	犍
jmo	腱
jmoa	睑
jmoj	暕
jmoz	腱
jmp	裥
jmpo	裥
jmr	件
jmra	俭
jmrd	剑
jmrn	牮
jmrz	健
jms	缄
jmsk	缄
jmsn	缣
jmu	碱
jmuj	饯
jmuk	碱
jmv	简
jmv	笕
jmvd	箭
jmve	舰
jmvj	笺
jmvo	简
jmx	尖
jmxd	尖
jmy	谏
jmy	戬
jmyd	谫
jmyg	艰
jmz	建
jmzj	践
jmzk	趼
jmzy	建
jmzz	踺
jn	叫
jna	鲛
jnau	斠
jnax	鲛
jnb	窖
jnbc	皭
jnbk	窖
jnbx	皎
jnc	蕉
jncb	藠
jncj	艽
jncx	茭
jnd	角
jndh	湫
jndw	浇
jndy	角
jne	峤
jnex	峧
jnf	搅
jnfe	搅
jnfj	搅
jni	较
jnil	轿
jniw	徼
jnix	蛟
jnj	铰
jnk	嚼
jnkc	嚼
jnkh	噍
jnl	教
jnlw	教
jnm	骄
jnml	骄
jnmx	校
jnmy	椒
jnn	娇
jnnx	姣
jno	脚
jnoe	脚
jnox	胶
jnq	狡
jnqx	狡
jnr	焦
jnrn	鹪
jnrw	侥
jnrx	佼
jns	缴
jnsw	缴
jnsx	绞
jnu	礁
jnul	矫
jnux	饺
jnv	剿
jnvd	剿
jnw	交
jnwe	郊
jnwn	䴔
jnwx	交
jnx	觉
jnxe	觉
jny	酵
jny	醮
jnz	跤
jnzx	跤
jp	接
jpa	鲒
jpak	鲒
jpb	皆
jpbb	皆
jpbe	疖
jpbl	疥
jpc	节
jpce	节
jpcl	芥
jpco	藉
jpd	洁
jpdb	湝
jpdn	解
jpe	阶
jpel	阶
jpf	揭
jpfk	拮
jpfn	㛃
jpfr	捷
jpfv	揭
jpfx	絜
jpg	戒
jph	秸
jpi	街
jpil	蚧
jpk	嗟
jpkb	喈
jpkg	嗟
jpl	竭
jplo	耤
jpm	杰
jpmb	楷
jpmh	杰
jpmk	桔
jpmn	檞
jpn	姐
jpnq	姐
jpnr	婕
jpo	睫
jpor	睫
jpr	借
jprl	介
jpro	借
jprv	偈
jps	结
jpsk	结
jpt	界
jptl	劫
jpu	截
jpuf	截
jpul	劼
jpur	颉
jpuv	碣
jpuy	届
jpv	孑
jpva	孑
jpwl	玠
jpx	桀
jpxc	悈
jpy	诫
jpy	诘
jpyg	讦
jpyv	羯
jq	久
jqa	鬏
jqah	鬏
jqb	究
jqb	疚
jqd	酒
jqdj	氿
jqdy	酒
jqe	㠇
jqey	㠇
jqf	揪
jqfa	韭
jqfh	揪
jqi	厩
jqiv	厩
jqj	舅
jqjh	灸
jqjn	鸠
jqk	啾
jqkh	啾
jql	旧
jqlo	旧
jqm	阄
jqmj	柩
jqmv	阄
jqp	九
jqpa	臼
jqpn	久
jqpv	九
jqq	救
jqqw	救
jqry	僦
jqs	纠
jqsl	纠
jqt	赳
jqtl	赳
jqw	玖
jqwk	咎
jqwn	鹫
jqwy	就
jr	卷
jrb	蠲
jrbi	蠲
jrd	涓
jrdo	涓
jre	嶲
jrf	捐
jrfo	捐
jrho	焆
jrj	镌
jrjm	桊
jrjn	镌
jrjo	眷
jrk	鹃
jrkn	鹃
jrkv	圈
jrm	棬
jrmv	棬
jrn	娟
jrno	娟
jrnv	婘
jrq	狷
jrqo	狷
jrr	倦
jrrn	隽
jrrv	倦
jrs	绢
jrso	绢
jrxe	鄄
jsb	窘
jsbk	窘
jsd	泂
jsdk	泂
jsh	炯
jshk	扃
jsk	囧
jskk	冏
jskv	囧
jsmk	𬳶
jso	炅
jsoh	䐃
jss	䌹
jssk	䌹
jst	坰
jstk	坰
jsz	迥
jszk	迥
jta	鳜
jtar	鳜
jtc	蕨
jtcr	蕨
jtd	决
jtdg	觖
jtdn	觖
jtdy	角
jte	崛
jtei	崛
jtf	掘
jtfg	抉
jtfi	掘
jtfn	抉
jtfr	撅
jtfy	攫
jth	爝
jthh	燋
jti	厥
jtid	劂
jtir	厥
jtj	镢
jtjr	镢
jtk	嚼
jtkc	嚼
jtkr	噘
jtku	噱
jtm	橛
jtmr	橛
jtmy	桷
jto	矍
jtoe	𨟠
jtoy	矍
jtp	爵
jtpc	爵
jtq	獗
jtqr	獗
jtqy	玃
jtr	倔
jtrf	傕
jtri	倔
jts	绝
jtu	砄
jtun	砄
jtv	孓
jtvn	孓
jtw	玦
jtwn	玦
jtwy	珏
jtx	觉
jtxe	觉
jty	诀
jtyg	诀
jtyk	谲
jtyy	叕
jtz	蹶
jtzr	蹶
ju	据
ju	居
jua	车
juak	𬶋
jual	车
jub	句
jubk	句
jubn	窭
jubq	疽
juc	菊
juc	苣
juck	莒
jucm	菊
jucq	苴
jud	沮
judk	泃
judq	沮
jue	聚
juej	岠
juek	崌
juen	聚
jueq	岨
juf	拒
jufk	拘
jufm	掬
jug	鞠
jugk	鞫
jugm	鞠
juh	炬
juhj	炬
juhk	焗
juj	锯
juj	飓
jujj	钜
jujk	锔
juk	巨
juka	巨
jukq	咀
jul	且
jula	且
jum	橘
jum	驹
jumj	柜
jumk	桔
juml	榉
jun	犋
junb	犋
juny	娵
juo	瞿
juof	瞿
juok	腒
juon	䴗
jup	裾
jupk	裾
juq	具
juqb	具
juqf	雎
juqq	狙
jur	俱
jurb	俱
jurk	倨
jut	趄
jutc	弆
jutq	趄
juu	局
juud	剧
juuj	矩
juuk	居
juun	屦
juuq	砠
juv	龃
juvk	筥
juvq	龃
juw	琚
juwq	珇
jux	举
jux	惧
juy	醵
juyj	讵
juz	距
juz	遽
juzk	踞
juzy	踽
jx	加
jx	佳
jxa	夹
jxag	戛
jxan	夹
jxb	家
jxbk	痂
jxby	瘕
jxc	荚
jxcj	荚
jxck	茄
jxcy	葭
jxd	浃
jxdj	浃
jxe	岬
jxej	岬
jxf	挟
jxfj	挟
jxfk	拮
jxfx	恝
jxh	稼
jxi	蛱
jxj	钾
jxj	镓
jxje	郏
jxjj	铗
jxjr	颊
jxku	斝
jxl	架
jxll	甲
jxlm	驾
jxly	袈
jxm	枷
jxmr	槚
jxn	嫁
jxo	胛
jxoj	胛
jxqd	猰
jxr	假
jxrk	伽
jxrl	价
jxrt	佳
jxu	嘉
jxuk	嘉
jxur	颉
jxv	笳
jxvk	笳
jxvy	叚
jxw	珈
jxwk	珈
jxx	贾
jxxr	贾
jxz	迦
jxzk	跏
jy	均
jyak	鲪
jyb	军
jybi	军
jyby	皲
jyc	菌
jych	菌
jyck	莙
jycw	葰
jyd	龟
jydw	浚
jye	峻
jyew	峻
jyf	捃
jyfk	捃
jyg	麇
jyh	焌
jyhw	焌
jyj	钧
jyjd	钧
jyl	竣
jylw	竣
jym	骏
jyo	晙
jyow	晙
jyr	俊
jyrn	隽
jyrw	俊
jyt	鋆
jytd	均
jytw	畯
jyv	筠
jyvd	筠
jyw	珺
jywk	珺
jyy	君
jyye	郡
k	可
k	块
ka	卡
kak	咖
kak	咯
kakb	咔
kakk	喀
kao	胩
kaob	胩
kau	卡
kaub	卡
kc	靠
kcd	洘
kcdv	洘
kcf	拷
kcfv	拷
kch	烤
kchf	㸆
kchv	烤
kcj	铐
kcjv	铐
kcl	考
kcm	栲
kcmv	栲
kcn	犒
kcnf	靠
kcnk	犒
kcu	尻
kd	开
kda	开
kdac	开
kdc	蒈
kdcb	蒈
kde	凯
kded	剀
kdej	凯
kdf	揩
kdfb	揩
kdh	炌
kdjb	锴
kdjj	铠
kdjk	锎
kdm	楷
kdmb	楷
kdt	垲
kdx	慨
kdxj	恺
kdxq	忾
kdxv	慨
ke	克
keb	客
kebg	窠
kebk	疴
kec	苛
keck	苛
ked	渴
kedk	可
kedm	溘
kee	岢
keek	岢
keg	颗
kegg	髁
keh	科
kehg	稞
kehk	炣
kei	轲
keik	轲
keiu	蝌
kej	铪
kejg	锞
kek	咳
kekk	呵
kekm	嗑
kekr	咳
kem	棵
kemg	骒
kemk	柯
keo	瞌
keom	瞌
kep	牁
kepk	牁
keq	氪
keqe	氪
kes	缂
kesg	缂
ket	坷
keu	壳
keue	克
keuj	壳
keum	磕
kew	刻
kewk	珂
kewr	颏
kex	恪
kexc	悈
key	课
keyg	课
kf	肯
kfg	恳
kfgt	垦
kfgx	恳
kfk	啃
kfko	啃
kfp	裉
kfpg	裉
kfug	硍
kfv	龈
kfvg	龈
kfvj	龂
kfvo	肯
kfwg	珢
kg	坑
kgj	铿
kgjt	铿
kgk	吭
kgkj	吭
kgt	坑
kgu	硁
kh	抗
kha	𩾌
khan	𩾌
khf	扛
khfg	扛
khfj	抗
khg	康
khgn	康
khh	炕
khj	钪
khjj	钪
khm	糠
khmj	闶
khmn	糠
khr	伉
khrj	伉
kht	𡐓
khtn	𡐓
khw	亢
khwj	亢
khx	慷
khxn	慷
kj	看
kjc	莰
kjcr	莰
kje	崁
kjer	崁
kjev	嵁
kjg	刊
kjgd	刊
kjii	衎
kjm	槛
kjmm	槛
kjmw	阚
kjo	瞰
kjow	瞰
kjq	勘
kjqg	戡
kjql	勘
kjr	侃
kjrl	龛
kjrv	侃
kjt	坎
kjtl	墈
kjtr	坎
kjtv	堪
kju	砍
kjul	磡
kjuo	看
kjur	砍
kk	快
kka	鲙
kkas	鲙
kkc	蒯
kkcd	蒯
kkcr	蒉
kkd	浍
kkds	浍
kkf	㧟
kkfk	㧟
kkk	哙
kkks	哙
kkmn	𫘝
kko	脍
kkos	脍
kkq	狯
kkqs	狯
kkr	会
kkre	郐
kkrs	侩
kkt	块
kktg	块
kktn	块
kkv	筷
kkvg	筷
kkvn	筷
kkxg	快
kkxn	快
kl	况
kld	夼
klde	况
kldi	夼
kldw	洭
klg	邝
klge	邝
klk	匡
klk	贶
klkw	哐
klm	框
klmw	框
klo	旷
klog	旷
klow	眶
klq	狂
klqn	𫛭
klqw	狂
kls	纩
klsg	纩
klt	圹
kltg	圹
klu	矿
klug	矿
klv	筐
klvw	筐
kly	诳
klyw	诓
ko	扩
kod	漷
kode	漷
kof	括
kofg	扩
kofk	括
kog	廓
koge	廓
koi	蛞
koik	蛞
kom	阔
komk	栝
kr	宽
krb	宽
krbe	宽
krg	髋
krge	髋
kru	款
krur	款
ks	空
ksbg	空
kse	崆
kseg	崆
ksf	控
ksfg	控
ksg	恐
ksgx	恐
ksr	倥
ksrg	倥
kstg	埪
ksu	矼
ksug	硿
ksv	箜
ksvg	箜
ksz	孔
kszv	孔
ku	酷
kub	窟
kuc	苦
kuck	苦
kud	刳
kug	库
kugi	库
kugk	骷
kuk	哭
kukf	圐
kukq	哭
kum	枯
kuo	朏
kuoi	朏
kup	裤
kupi	裤
kus	绔
kusk	绔
kuu	矻
kuuq	矻
kux	喾
kuy	酷
kuyk	酷
kv	亏
kvb	窥
kvbe	窥
kvbw	夔
kvc	葵
kvcr	蒉
kvct	葵
kvd	溃
kvdr	溃
kvdt	奎
kve	岿
kvee	岿
kveg	隗
kver	聩
kvev	亏
kvf	揆
kvft	揆
kvg	魁
kvgu	魁
kvht	煃
kvi	蝰
kvit	蝰
kvj	馗
kvk	匮
kvko	喟
kvkr	匮
kvkt	喹
kvmt	骙
kvmu	櫆
kvo	睽
kvot	暌
kvr	傀
kvrg	傀
kvu	盔
kvum	盔
kvur	馈
kvv	篑
kvvg	戣
kvvr	篑
kvx	愧
kvxg	愧
kvxl	悝
kvxr	愦
kvz	逵
kvzt	跬
kw	剋
kwud	剋
kx	夸
kxd	夸
kxdk	夸
kxf	挎
kxfk	挎
kxnk	姱
kxo	胯
kxok	胯
kxr	侉
kxrk	侉
kxt	垮
kxtk	垮
kxz	跨
kxzk	跨
ky	困
kya	鲲
kyab	鲲
kyaw	髡
kye	崑
kyeb	崑
kyf	捆
kyfm	捆
kyft	堃
kyh	焜
kyhb	焜
kyj	锟
kyjb	锟
kykm	困
kymm	阃
kynb	婫
kyo	昆
kyob	昆
kyon	鹍
kypi	裈
kyt	坤
kytu	坤
kyu	壸
kyuy	壸
kyw	琨
kywb	琨
kyxm	悃
kyy	醌
kyyb	醌
kz	口
kz	抠
kzb	寇
kzby	寇
kzc	蔻
kzck	芤
kzcv	芤
kzcy	蔻
kzf	扣
kzfk	扣
kzfx	抠
kzgx	𫸩
kzk	叩
kzl	竘
kzla	口
kzo	眍
kzox	眍
kzv	筘
kzvk	筘
l	了
l	立
la	拉
laad	𬶟
lab	瘌
labd	瘌
lac	落
lack	落
lafl	拉
lag	鞡
lagl	鞡
lai	蜡
laid	蝲
laio	蜡
laj	镴
lajv	镴
lak	啦
lak	喇
lakl	啦
lal	辣
lalu	辣
lao	腊
laoj	旯
laoo	腊
lat	垃
latl	垃
lau	剌
laud	剌
laul	砬
laz	邋
lazv	邋
lb	林
lba	鳞
lbal	鳞
lbc	蔺
lbcf	蔺
lbd	淋
lbdl	潾
lbdm	淋
lbdx	凛
lbe	嶙
lbel	嶙
lbf	拎
lbfs	拎
lbg	麟
lbgl	麟
lbgx	廪
lbi	辚
lbk	啉
lbkm	啉
lbl	临
lbll	临
lbm	粼
lbml	粦
lbmv	粼
lbmx	檩
lbo	瞵
lbol	膦
lbr	邻
lbre	邻
lbrr	赁
lbu	磷
lbul	磷
lbvm	箖
lbw	琳
lbwk	吝
lbwl	璘
lbwm	琳
lbxx	懔
lby	霖
lbym	霖
lbz	躏
lbzf	躏
lbzl	遴
lc	老
lcb	牢
lcbl	痨
lcbn	牢
lcc	劳
lccb	荖
lcck	落
lccl	劳
lcd	涝
lcdl	涝
lcdx	潦
lce	崂
lcel	崂
lcf	捞
lcfl	捞
lch	烙
lchk	烙
lcj	铑
lcjb	铑
lcjl	铹
lck	唠
lckl	唠
lcl	耢
lclb	老
lcll	耢
lcm	栳
lcmb	栳
lcn	姥
lcnb	姥
lcnp	嫪
lcr	佬
lcrb	佬
lcs	络
lcsk	络
lctl	𫭼
lcy	酪
lcyp	醪
ld	来
lda	来
ldan	来
ldb	癞
ldbr	癞
ldc	莱
ldcl	莱
ldd	濑
lddl	涞
lddr	濑
lde	崃
ldel	崃
ldi	徕
ldil	徕
ldlr	赉
ldm	梾
ldml	梾
ldo	睐
ldol	睐
ldrl	俫
ldu	赖
ldur	赖
ldv	籁
ldvr	籁
le	乐
lea	鳓
leal	鳓
led	泐
ledl	泐
leg	勒
legl	勒
lek	嘞
lekl	叻
leo	肋
leol	肋
lep	乐
lepd	乐
ler	仂
lerl	仂
leu	饹
leuk	饹
lev	簕
levl	了
lg	冷
lge	崚
lgew	崚
lgm	楞
lgmw	棱
lgt	塄
lgtf	塄
lgtw	堎
lgx	愣
lgxf	愣
lh	浪
lhc	莨
lhcl	蒗
lhco	蓢
lhd	郎
lhde	郎
lhdl	浪
lhdm	㮾
lhdo	朗
lhdt	塱
lhe	崀
lhel	崀
lhg	廊
lhge	廊
lhh	烺
lhhl	稂
lhi	螂
lhie	螂
lhj	锒
lhjl	锒
lhk	啷
lhke	啷
lhm	榔
lhme	榔
lhml	阆
lho	㫰
lhol	㫰
lhq	狼
lhql	狼
lhtl	埌
lhvl	筤
lhw	琅
lhwl	琅
li	里
lia	丽
liaa	鳢
liad	丽
lial	鲤
lian	吏
lib	痢
libl	疬
libw	疠
lic	莉
lic	荔
licl	莅
licu	藜
lid	漓
lida	澧
lidl	沥
lidm	溧
lie	峛
lied	峛
liel	𫵷
lih	利
lihh	黧
lihm	梨
lihn	犁
lihq	戾
lihu	黎
lii	历
lii	厘
liid	蜊
liil	励
liiw	厉
liiw	蛎
lij	锂
lik	哩
likl	喱
likq	唳
lil	郦
lil	鹂
lila	里
lim	李
lim	骊
liml	粒
liml	栎
limu	㰀
limw	粝
limz	李
lin	娌
linl	娌
lip	礼
lipv	礼
liq	狸
liqd	猁
liql	狸
lir	例
lir	俚
lird	俐
lirl	俪
lirm	傈
lis	罹
lisd	缡
lisf	罹
lisk	詈
lit	坜
litl	坜
liu	砾
liul	砬
liuw	砺
liv	力
liv	蠡
livd	篱
livl	笠
livm	篥
livn	隶
livp	力
liw	离
liw	璃
liwa	立
liwl	理
liwn	嫠
lix	栗
liy	雳
liya	醴
liyd	醨
liyl	雳
liyy	叕
liz	逦
lizl	跞
ljb	兰
ljbs	兰
ljc	蓝
ljcm	蓝
ljd	滥
ljdj	澜
ljdm	滥
lje	岚
ljex	岚
ljf	拦
ljfe	揽
ljfs	拦
ljh	烂
ljhs	烂
ljj	镧
ljjj	镧
ljk	啉
ljkm	啉
ljl	览
ljm	栏
ljme	榄
ljmj	阑
ljmn	婪
ljms	栏
ljo	暕
ljoj	暕
ljp	褴
ljpj	襕
ljs	缆
ljsg	罱
ljue	𬒗
ljv	篮
ljvm	篮
ljw	斓
ljwj	斓
ljx	懒
ljxr	懒
ljy	谰
ljyj	谰
lk	另
lka	鲮
lkaw	鲮
lkc	菱
lkcs	苓
lkcw	菱
lkd	凌
lkd	泠
lkdw	凌
lke	岭
lkeh	灵
lkes	聆
lkew	陵
lki	蛉
lkis	蛉
lkj	铃
lkjs	铃
lkk	呤
lkk	囹
lkkl	另
lkm	棱
lkmh	棂
lkms	柃
lkmw	棱
lkn	姈
lkns	姈
lkos	昤
lkp	祾
lkpw	祾
lkr	令
lkrn	鸰
lkrr	领
lkrs	伶
lkrw	瓴
lkrx	翎
lks	绫
lksw	绫
lkt	坽
lkv	龄
lkvs	舲
lkvv	〇
lkw	玲
lkws	玲
lkxw	㥄
lky	零
lky	羚
lkye	酃
ll	两
lla	两
llad	两
llc	莨
llcl	𬜯
lld	梁
lld	粱
lldg	良
lldl	量
lldx	凉
llf	靓
llfe	靓
llg	魉
lli	辆
llil	辆
llix	辌
llm	粮
llml	粮
llmx	椋
llo	量
llol	量
llox	晾
llr	俩
llrl	俍
llsx	𫟅
llt	墚
llw	亮
llx	悢
lly	谅
llz	踉
llzl	踉
lm	连
lma	鲢
lmaj	𬶠
lmaz	鲢
lmb	帘
lmc	莲
lmca	莶
lmcw	蔹
lmcz	莲
lmd	涟
lmd	殓
lmdn	濂
lmdw	潋
lmdx	奁
lmdz	涟
lme	联
lmet	联
lmg	廉
lmgn	廉
lmh	炼
lmhd	炼
lmi	蠊
lmin	蠊
lmj	链
lmjn	镰
lmjz	链
lmm	楝
lmmj	楝
lmmz	梿
lmo	脸
lmoa	脸
lmp	裢
lmpa	裣
lmpz	裢
lmr	敛
lmrw	敛
lms	练
lmun	磏
lmw	恋
lmwj	瑓
lmwx	恋
lmwz	琏
lmx	怜
lmxs	怜
ln	料
lna	鹩
lnan	鹩
lnb	疗
lnbp	寥
lnbx	寮
lnc	蓼
lncp	蓼
lnd	潦
lndn	鹩
lndp	漻
lne	聊
lnee	聊
lnf	撩
lnfk	撂
lnfx	撩
lng	廖
lngp	廖
lnh	燎
lnhx	燎
lnj	镣
lnjl	钌
lnjx	镣
lnk	嘹
lnkx	嘹
lnm	料
lnmu	料
lnmx	橑
lnnx	嫽
lno	瞭
lnox	瞭
lnq	獠
lnqx	獠
lnr	僚
lnrx	僚
lns	缭
lnsx	缭
lntp	𪤗
lnu	尥
lnuu	尥
lnv	了
lnvl	了
lnvx	簝
lnx	憭
lnz	辽
lnzl	辽
lnzx	蹽
lo	落
lob	瘰
lobx	瘰
loc	萝
locg	蓏
lock	落
locn	荦
locx	萝
lod	洛
lodl	泺
lodx	漯
lof	摞
lofc	捋
lofx	摞
loh	烙
lohk	烙
loi	螺
loix	螺
loj	锣
lojx	锣
lok	咯
lokk	咯
lokx	啰
lom	骡
lomk	骆
lomx	椤
loo	脶
loon	脶
lop	裸
lopg	裸
loq	猡
loqx	猡
lor	倮
lorg	倮
los	罗
losk	络
losx	罗
lou	硌
louk	硌
lov	箩
lovx	箩
low	雒
lowk	珞
loz	逻
lozl	跞
lozx	逻
lp	列
lpa	鬣
lpav	𫚭
lpd	裂
lpdd	冽
lpdd	洌
lpdh	烈
lpdn	䴕
lpdy	裂
lpf	捩
lpfq	捩
lpk	咧
lpo	脟
lpoc	脟
lpq	猎
lpqo	猎
lpt	趔
lptc	埒
lptd	趔
lpu	劣
lpul	劣
lpz	躐
lq	刘
lq	溜
lqb	瘤
lqbt	瘤
lqd	流
lqdd	浏
lqdj	鎏
lqdp	漻
lqdt	溜
lqdv	流
lqdy	瑬
lqe	陆
lqej	陆
lqf	旒
lqfv	旒
lqh	熘
lqht	熘
lqj	镏
lqjp	镠
lqjt	飗
lqjv	锍
lqm	柳
lqm	骝
lqme	柳
lqmt	榴
lqp	留
lqpn	鹠
lqpt	留
lqs	绺
lqsk	绺
lqst	罶
lqtp	疁
lqu	硫
lqut	馏
lqw	六
lqwb	六
lqwd	刘
lqwe	珋
lqwv	琉
lqx	鹨
lqz	遛
lqzt	遛
lr	乱
lrd	滦
lrdm	滦
lrp	卵
lrpd	卵
lrq	乱
lrqv	乱
lrw	鸾
lrwe	峦
lrwj	銮
lrwm	栾
lrwn	娈
lrwr	脔
lrwu	挛
lrwz	孪
ls	龙
lsb	窿
lsbu	癃
lscl	茏
lsdl	泷
lsdu	漋
lse	隆
lsel	陇
lseu	隆
lsf	拢
lsfl	拢
lsk	咙
lskc	哢
lskl	咙
lsl	聋
lslt	垄
lslu	砻
lsm	栊
lsml	栊
lso	胧
lsol	眬
lsu	龙
lsud	尨
lsv	笼
lsvl	笼
lsvr	𬕂
lsw	弄
lswc	弄
lswl	珑
ltf	掠
ltfu	䂮
ltfx	掠
ltj	锊
ltjc	锊
ltk	圙
ltkm	圙
ltt	略
lttk	略
lu	路
lua	鲁
luao	鲁
luau	鲈
luc	芦
luck	蕗
lucp	蓼
lucu	菉
lud	泸
ludb	漉
ludk	潞
ludo	澛
ludu	渌
lue	陆
luej	陆
luf	撸
lufl	掳
lufo	撸
lug	鹿
lugb	鹿
lugh	庐
luh	炉
luhh	炉
luhl	虏
luht	稑
lui	轳
luib	辘
luik	辂
luj	镥
lujo	镥
luju	𬬻
luk	赂
luko	噜
lul	卢
luln	鸬
lulr	颅
lulx	卤
lum	橹
lumb	麓
lumo	氇
lumu	栌
luo	胪
luou	胪
lup	禄
lupu	禄
lupy	甪
lurp	僇
lus	绿
lut	垆
luu	碌
luv	录
luw	璐
luwb	六
luwk	璐
luwu	琭
lux	勠
luxg	戮
luy	露
luz	鹭
luzk	路
luzn	鹭
luzu	逯
lv	率
lvcy	葎
lvd	滤
lvdx	滤
lvf	旅
lvfc	捋
lvfn	旅
lvfo	膂
lvh	虑
lvhk	稆
lvi	律
lviy	律
lvj	铝
lvk	吕
lvkk	吕
lvm	驴
lvmh	驴
lvmk	榈
lvmk	闾
lvo	𦝼
lvon	𦝼
lvp	褛
lvpn	褛
lvq	氯
lvqu	氯
lvr	侣
lvrk	侣
lvrn	偻
lvs	绿
lvsn	缕
lvsu	绿
lvty	垏
lvu	屡
lvun	屡
lvuw	履
lvw	率
lvwu	率
lw	类
lwa	耒
lwan	耒
lwbt	癗
lwc	蕾
lwct	藟
lwd	泪
lwdo	泪
lwdx	漯
lwf	擂
lwfn	耒
lwft	擂
lwg	勒
lwj	镭
lwjt	镭
lwk	嘞
lwm	檑
lwmd	类
lwmt	檑
lwn	嫘
lwnx	嫘
lwo	肋
lwol	肋
lwr	儡
lwrt	儡
lws	垒
lwst	垒
lwsx	缧
lwt	累
lwtf	罍
lwtx	累
lwu	磊
lwut	礌
lwuu	磊
lww	羸
lwwf	羸
lwy	雷
lwyc	酹
lwyl	诔
lwyt	雷
lxr	俩
lxrl	俩
ly	论
lyd	沦
lydb	沦
lyf	抡
lyfb	抡
lyi	轮
lyib	轮
lyjb	𬬭
lyk	囵
lykb	囵
lyr	伦
lyrb	仑
lys	纶
lysb	纶
lytb	𫭢
lyyb	论
lz	楼
lza	剅
lzad	剅
lzb	瘘
lzbn	瘘
lzc	蒌
lzcn	蒌
lzd	漏
lze	陋
lzen	嵝
lzev	陋
lzf	搂
lzfn	搂
lzg	髅
lzgn	髅
lzi	蝼
lzin	蝼
lzj	镂
lzjn	镂
lzk	喽
lzkn	喽
lzl	耧
lzln	耧
lzm	娄
lzmn	楼
lzo	䁖
lzon	䁖
lzr	偻
lztn	𪣻
lzv	篓
lzvn	篓
lzy	露
lzyk	露
m	没
m	嘛
ma	吗
ma	骂
maf	抹
mafm	抹
mag	麻
magm	麻
magu	摩
mai	蚂
maid	蟆
maim	蚂
mak	嘛
makm	骂
makw	唛
mam	杩
mamm	杩
man	妈
manm	妈
map	祃
mapm	祃
maq	犸
maqm	犸
mau	码
maum	码
mav	马
maw	玛
mawm	玛
maz	孖
mazz	孖
mb	民
mbc	苠
mbcm	苠
mbd	泯
mbdm	泯
mbdo	湣
mbe	岷
mbem	岷
mbf	抿
mbfm	抿
mbk	黾
mbkd	黾
mbl	皿
mbla	皿
mbm	闽
mbmi	闽
mbmw	闵
mbmx	愍
mbo	旻
mbow	旻
mbp	敏
mbpa	鳘
mbpw	敏
mbs	缗
mbso	缗
mbuo	碈
mbvv	民
mbw	玟
mbwm	珉
mbww	玟
mbwx	忞
mbx	悯
mbxw	悯
mc	毛
mca	髦
mcam	髦
mcc	茂
mcce	茆
mccm	芼
mccp	茅
mccw	茂
mcd	泖
mcde	泖
mce	峁
mcee	峁
mcf	旄
mcfm	旄
mcj	帽
mcje	铆
mcjo	帽
mcjt	锚
mck	冒
mcko	冒
mcl	耄
mclm	耄
mcm	懋
mcmm	楙
mcmx	懋
mcn	牦
mcnm	牦
mco	冒
mcoe	昴
mcom	眊
mcoo	冒
mcp	贸
mcpe	卯
mcpr	贸
mcpv	毛
mcq	猫
mcqt	猫
mcs	矛
mcso	瞀
mcsp	矛
mcuk	冇
mcv	貌
mcw	袤
mcwo	瑁
mcwy	袤
md	买
mdc	荬
mdf	麦
mdfw	麦
mdk	唛
mdkw	唛
mdo	脉
mdoy	脉
mdt	埋
mdtl	埋
mdu	卖
mdud	卖
mdvd	买
mdw	劢
mdwl	劢
mdy	霾
mdyl	霾
mdz	迈
mdzw	迈
me	么
mep	么
meps	么
mf	们
mfd	门
mfdv	门
mfdw	汶
mfdx	懑
mff	扪
mffm	扪
mfg	鞔
mfgv	鞔
mfh	焖
mfhx	焖
mfj	钔
mfjm	钔
mfm	闷
mfmx	闷
mfrm	们
mfwl	𫞩
mfwq	亹
mfxo	惛
mg	梦
mgc	萌
mgcn	蒙
mgco	瞢
mgcu	蒙
mgcw	甍
mgdn	濛
mgdu	濛
mge	㠓
mgen	㠓
mgeu	㠓
mgi	蜢
mgic	蟒
mgim	蜢
mgin	蠓
mgiu	蠓
mgiw	虻
mgj	锰
mgjn	幪
mgju	幪
mgk	𫑡
mgkd	黾
mgke	𫑡
mgm	檬
mgmn	檬
mgmu	檬
mgmx	梦
mgo	盟
mgom	盟
mgon	朦
mgou	朦
mgq	猛
mgqm	猛
mgqn	獴
mgqu	獴
mgu	礞
mgud	尨
mgun	礞
mguu	礞
mgv	艋
mgvm	艋
mgvn	艨
mgw	氓
mgwm	氓
mgx	懵
mgxo	懵
mgzl	勐
mgzm	孟
mh	忙
mhc	茫
mhcc	莽
mhcw	芒
mhd	漭
mhdc	漭
mhi	蟒
mhic	蟒
mhid	厖
mhmw	杧
mhn	牤
mhnd	牻
mhnw	牤
mhu	硭
mhud	尨
mhuw	硭
mhw	盲
mhwe	邙
mhwm	氓
mhwo	盲
mhx	忙
mi	米
mib	密
mibb	宓
mibe	密
mibi	蜜
mibj	幂
mic	蘼
mica	蘼
micf	蘼
mid	泌
midb	泌
midm	洣
mido	汨
mig	弥
mig	麋
mige	弭
migf	靡
migm	糜
migx	縻
mih	秘
mihb	秘
mik	咪
mike	嘧
mikm	咪
mill	芈
mim	敉
mimw	敉
mio	眯
miom	脒
mip	觅
mipb	祕
mipe	觅
mipx	祢
miq	猕
miqx	猕
miy	谜
miym	谧
miyz	醚
miz	迷
mizm	迷
mj	慢
mja	鳗
mjay	鬘
mjc	蔓
mjck	𬜬
mjcr	颟
mjcy	蔓
mjd	满
mjdl	满
mjdw	𬇕
mjdy	漫
mjg	鞔
mjgv	鞔
mji	螨
mjil	螨
mjj	幔
mjjy	镘
mjn	嫚
mjny	嫚
mjo	瞒
mjol	瞒
mjoy	曼
mjs	缦
mjtl	埋
mjty	墁
mju	馒
mjuy	馒
mjw	蛮
mjwi	蛮
mjx	慢
mjxy	慢
mjy	谩
mjyy	谩
mk	名
mkb	冥
mkbb	冥
mkc	茗
mkcb	蓂
mkck	茗
mkd	溟
mkdb	溟
mkdk	洺
mki	螟
mkib	螟
mkj	铭
mkk	鸣
mkkn	鸣
mko	明
mkob	瞑
mkob	暝
mkoo	明
mkr	命
mkre	命
mky	酩
mkyk	酩
mm	面
mma	丏
mmaa	面
mmav	𩾃
mmd	免
mmd	沔
mmdd	渑
mmdl	勉
mmdm	湎
mmk	黾
mmkd	黾
mmkv	冕
mmm	棉
mmmj	棉
mmml	勔
mmn	娩
mmnv	娩
mmo	眠
mmom	腼
mmov	冕
mmrm	偭
mms	绵
mmsj	绵
mmsm	缅
mn	秒
mnc	苗
mnce	藐
mncn	鹋
mnct	苗
mnd	渺
mndu	渺
mnf	描
mnft	描
mng	庙
mnk	喵
mnkt	喵
mnm	杪
mnmu	杪
mnn	妙
mnnu	妙
mno	瞄
mnot	瞄
mnou	眇
mns	缈
mnsp	缪
mnsu	缈
mnu	淼
mnz	邈
mnze	邈
mo	末
moa	万
moan	末
moap	万
moav	无
moay	无
mob	寞
moc	莫
moc	蘑
mocd	莫
mocm	蓦
mocm	茉
mocu	摹
mod	漠
modm	沫
mody	殁
moe	陌
moeb	陌
mof	摸
mofd	摸
mofm	抹
mog	磨
mog	摩
mogg	魔
mogm	麽
moh	墨
mohm	秣
mohq	默
moht	墨
moj	镆
mojd	镆
moko	冒
mol	耱
mom	模
momd	模
mon	嬷
mond	嫫
moo	膜
mood	膜
mooo	冒
mooy	脉
mop	么
mops	么
mos	𬙊
most	𬙊
mou	馍
moud	馍
mov	貊
movb	貊
movd	貘
movk	貉
moy	谟
moyd	谟
mp	灭
mpa	灭
mpah	灭
mpc	蔑
mpcu	蔑
mpk	咩
mpky	咩
mpv	篾
mpvu	篾
mpvv	乜
mqs	缪
mqsp	缪
mqy	谬
mqyp	谬
mu	目
mua	木
muan	木
muc	幕
muc	苜
mucj	幕
mucl	募
muco	暮
muct	墓
mucx	慕
mud	沐
mudm	沐
muf	拇
mufm	拇
muh	穆
muhp	穆
muj	钼
mujm	𬭁
mujo	钼
muk	目
muka	目
mum	模
mumd	模
mumn	毪
mun	姆
munb	姥
munt	牡
munw	牧
muo	睦
muot	睦
murm	仫
mus	牟
musn	牟
muu	木
muun	木
muv	母
muvd	母
muw	亩
muwt	亩
muzm	𧿹
mw	每
mw	梅
mwb	寐
mwbw	寐
mwc	莓
mwcm	莓
mwd	湄
mwdo	湄
mwdv	浼
mwdy	没
mwe	嵋
mweo	嵋
mwg	魅
mwgm	糜
mwh	煤
mwhm	煤
mwj	镁
mwjd	镁
mwjo	镅
mwm	枚
mwmm	梅
mwmo	楣
mwn	妹
mwn	媒
mwnd	媄
mwno	媚
mwnw	妹
mwo	昧
mwow	昧
mwp	袂
mwpg	袂
mwpn	袂
mwv	眉
mwvn	鹛
mwvo	眉
mww	玫
mwwo	瑂
mwy	霉
mwyd	美
mwym	酶
mz	某
mzgm	某
mzi	蛑
mzin	蛑
mzk	哞
mzkm	呣
mzkn	哞
mzo	眸
mzon	眸
mzr	侔
mzrn	侔
mzs	牟
mzsj	鍪
mzsn	牟
mzsp	缪
mzy	谋
mzym	谋
n	你
n	哪
na	那
nace	𦰡
naf	捺
nafx	捺
naj	钠
naju	镎
nak	哪
nakn	呐
nan	娜
nane	娜
nao	肭
naon	肭
nap	衲
napn	衲
nar	拿
nas	纳
nasn	纳
nau	南
naug	南
naym	乸
nb	您
nbr	您
nbrx	您
nc	闹
ncb	孬
ncbz	孬
ncd	淖
ncdu	淖
ncf	挠
ncfw	挠
nci	蛲
nciw	蛲
ncj	铙
ncjw	铙
nck	呶
ncky	呶
ncm	桡
ncmj	闹
ncmw	桡
ncnn	嫐
nco	脑
ncoe	臑
ncok	脑
ncq	猱
ncqe	峱
ncqm	猱
nct	垴
nctk	垴
ncu	硇
ncux	硇
ncw	瑙
ncwx	瑙
ncx	恼
ncxk	恼
ndc	萘
ndcn	艿
ndcx	萘
ndd	奈
nddx	奈
nde	耐
ndec	耐
ndep	耏
ndm	柰
ndmx	柰
ndn	奶
ndnn	奶
ndnv	鼐
ndq	氖
ndqn	氖
ndr	佴
ndv	乃
ndvp	乃
ndzx	迺
ne	呢
nek	呐
nekb	呢
neke	哪
nekn	呐
ney	讷
neyn	讷
nf	嫩
nfnd	媆
nfnw	嫩
nfr	恁
nfrx	恁
ng	能
ngs	能
ngsb	能
nh	囊
nha	囊
nhay	囊
nhdy	瀼
nhf	攮
nhfy	攮
nhk	囔
nhky	囔
nho	曩
nhoy	曩
nhuy	馕
nhzy	齉
ni	泥
nia	鲵
niae	鲵
nib	疑
nibr	疑
nic	薿
nicr	薿
nid	溺
nidb	泥
nidd	溺
nie	𨺙
niee	𨺙
nif	拟
nifb	旎
nifr	拟
nige	麑
niie	𫐐
nij	铌
nijb	铌
nik	匿
nikb	呢
nikk	匿
nin	妮
ninb	妮
nio	腻
niob	昵
nioe	睨
nior	腻
niq	猊
niqe	猊
nir	倪
nirb	伲
nire	倪
nirx	你
nit	坭
nitb	坭
niu	尼
niub	尼
nive	𫠜
nix	怩
nixb	怩
niy	霓
niye	霓
niz	逆
nizp	逆
nj	难
nja	南
njc	萳
njcg	萳
nji	蝻
njig	蝻
njk	喃
njkg	喃
njkn	囡
njm	楠
njmg	楠
njng	婻
njo	腩
njog	腩
njt	男
njtl	男
njty	赧
nju	南
njyf	难
nk	宁
nkb	宁
nkbd	宁
nkby	甯
nkcd	苧
nkd	凝
nkdd	泞
nkdr	凝
nke	聍
nked	聍
nkf	拧
nkfd	拧
nkk	咛
nkkd	咛
nkm	柠
nkmd	柠
nkq	狞
nkqd	狞
nkr	佞
nkrn	佞
nln	娘
nlny	孃
nly	酿
nlyl	酿
nm	年
nma	廿
nmaa	廿
nmak	鲇
nmax	鲶
nmc	蔫
nmca	廿
nmch	蔫
nmf	撵
nmfi	辇
nmfk	拈
nmfx	捻
nmh	黏
nmhk	黏
nmi	辗
nmin	辗
nmm	粘
nmmk	粘
nmp	年
nmpl	年
nmr	念
nmrx	念
nmt	埝
nmtx	埝
nmu	碾
nmun	碾
nn	鸟
nnc	茑
nncn	茑
nnd	溺
nndd	溺
nno	脲
nnou	脲
nnp	袅
nnpa	鸟
nnpy	袅
nnt	嬲
nntl	嬲
nnu	尿
nnuu	尿
nnw	鸟
nnwd	鸟
no	挪
noc	𦰡
noce	𦰡
nof	挪
nofd	搦
nofe	挪
noj	锘
nojk	锘
nok	喏
nokk	喏
nom	糯
nome	糯
non	娜
none	娜
nor	傩
norf	傩
nox	懦
noxe	懦
noy	诺
noyk	诺
np	捏
npc	孽
npcm	蘖
npcx	菍
npcz	孽
npd	涅
npdt	涅
npe	聂
npem	嵲
nper	颞
npet	陧
npey	聂
npf	摄
npft	捏
npfy	摄
npj	镊
npjm	镍
npjy	镊
npk	啮
npkk	啮
npky	嗫
npm	𫔶
npmm	𫔶
npv	乜
npvv	乜
npz	蹑
npzm	臬
npzy	蹑
nq	牛
nqf	扭
nqfi	扭
nqfl	拗
nqj	钮
nqji	钮
nqm	杻
nqmi	杻
nqn	妞
nqpl	牛
nqq	狃
nqs	纽
nqsi	纽
nqx	忸
nqxi	忸
nr	暖
nro	暖
nroy	暖
ns	弄
ns	浓
nsd	农
nsdn	浓
nsh	秾
nshn	秾
nsk	哝
nskn	哝
nso	脓
nson	脓
nsr	侬
nsrn	侬
nsw	弄
nswc	弄
nsy	𬪩
nsyn	𬪩
nt	虐
ntb	疟
ntba	疟
nth	虐
ntha	虐
nu	怒
nun	奴
nung	弩
nunl	努
nunm	驽
nunr	胬
nunu	砮
nunx	怒
nuny	奴
nunz	孥
nurc	傉
nuvy	笯
nv	女
nvex	恧
nvj	钕
nvjn	钕
nvv	女
nvva	女
nvx	衄
nvxi	衄
nw	内
nwk	哪
nwld	内
nwu	馁
nwun	馁
nwv	那
nwve	那
nzl	耨
nzlc	耨
o	哦
og	嗯
ogkx	嗯
omk	呣
omkm	呣
omkw	呒
onk	嗯
onkx	嗯
oo	喔
ook	噢
ookd	噢
ookt	喔
ookw	哦
ooky	嚄
ou	欧
ouc	藕
oucy	藕
oud	沤
oudx	沤
ouhx	𬉼
ouk	呕
oukn	鸥
oukr	欧
oukw	瓯
oukx	区
ouky	殴
oul	耦
oulk	𠙶
ouly	耦
our	偶
oury	偶
out	𫭟
outx	𫭟
oux	怄
ouxx	怄
ouy	讴
ouyx	讴
p	平
pa	怕
pac	葩
pacb	葩
padb	潖
paf	扒
pafb	扒
paj	帕
pajb	帕
pak	啪
pakb	啪
pal	耙
palb	耙
pam	杷
pamb	杷
pav	爬
pavb	筢
paw	琶
pawb	琶
pax	怕
paxb	怕
paz	趴
pazb	趴
pb	品
pbb	贫
pbbr	贫
pbcr	𬞟
pbe	聘
pbev	聘
pbf	拼
pbfk	拼
pbk	品
pbkk	品
pbn	嫔
pbnb	牝
pbnk	姘
pbv	频
pbvr	频
pbvu	颦
pbw	玭
pbwb	玭
pc	跑
pcb	刨
pcbd	刨
pcbs	疱
pcch	藨
pcd	泡
pcd	匏
pcf	抛
pcfl	抛
pcg	庖
pcgs	庖
pch	炮
pck	咆
pco	脬
pcoz	脬
pcp	袍
pcps	袍
pcq	狍
pcqs	狍
pcz	跑
pczs	跑
pd	排
pdc	蒎
pdcn	蒎
pdd	派
pddf	湃
pddn	派
pdf	拍
pdfb	拍
pdff	排
pdi	徘
pdif	徘
pdk	哌
pdkn	哌
pdp	牌
pdpu	牌
pdr	俳
pdz	迫
pdzb	迫
pf	盆
pfbm	盆
pfd	湓
pfdm	湓
pfk	喷
pfkr	喷
pg	碰
pgc	蓬
pgcf	芃
pgcp	苹
pgcz	蓬
pgd	澎
pgdo	淜
pgdp	泙
pgf	捧
pgff	搒
pgfl	捧
pgfp	抨
pggo	弸
pgi	蟛
pgip	蟛
pgk	嘭
pgkp	嘭
pgm	棚
pgmo	棚
pgmy	椪
pgo	朋
pgon	鹏
pgoo	朋
pgop	膨
pgt	堋
pgto	堋
pgu	彭
pguo	硼
pgup	砰
pguy	碰
pgv	篷
pgvz	篷
pgw	烹
pgwh	烹
pgx	怦
pgxp	怦
ph	旁
pha	鳑
phaf	鳑
phd	滂
phdf	滂
phg	庞
phi	螃
phif	彷
phl	耪
phlf	耪
pho	胖
phob	胖
phof	膀
phq	乓
phqd	乓
phu	磅
phud	尨
phuf	磅
phw	旁
phwf	旁
phy	雱
phyf	雱
phz	逄
phzl	逄
pi	批
piay	鲏
pib	疲
piba	丕
pibe	邳
pibk	痞
pibk	否
pibu	癖
piby	疲
picb	芘
pice	苉
pid	淠
pidl	濞
pidu	澼
pie	陂
pieu	陴
piey	陂
pif	披
pifb	批
pify	披
pii	蜱
piib	蚍
piiu	蜱
pij	铍
pijy	铍
pik	啤
pikb	吡
pike	匹
piku	噼
pim	枇
pima	𬳵
pimb	枇
pimp	𬳵
pin	媲
pinb	媲
pio	脾
piou	睥
pip	郫
pipe	邳
pipu	裨
pipy	被
piqp	狉
pir	僻
pirb	仳
pirp	伾
pis	纰
pisb	纰
pish	罴
piss	罢
pit	坯
pitb	毗
pitj	圮
pitp	坯
pitu	埤
piu	屁
piub	砒
piud	劈
piuk	譬
piun	䴙
piuu	辟
piuw	甓
piv	皮
pivb	貔
piw	琵
piwb	琵
piy	霹
piyu	霹
pj	盘
pjb	判
pjbd	判
pjby	叛
pjd	潘
pjdb	泮
pjdt	潘
pjdy	湴
pjf	拌
pjfb	拌
pji	蟠
pjit	蟠
pjm	攀
pjmb	柈
pjmu	攀
pjo	盼
pjob	胖
pjod	盼
pjp	襻
pjpb	袢
pjpt	番
pjpu	襻
pjt	畔
pjtb	畔
pjut	磻
pjv	磐
pjvl	爿
pjvm	槃
pjvp	爿
pjvu	磐
pjz	蹒
pjzl	蹒
pk	凭
pka	平
pkap	鲆
pkau	平
pkb	瓶
pkc	萍
pkck	荓
pkcp	苹
pkcr	𬞟
pkd	洴
pkdo	淜
pkdp	泙
pkdv	涄
pkip	蚲
pkm	枰
pkmp	枰
pkn	娉
pknv	娉
pkq	乒
pkqp	乒
pkr	俜
pkrj	凭
pkt	坪
pktp	坪
pku	屏
pkuk	屏
pkwp	玶
pky	评
pkyp	评
pm	片
pmh	翩
pmhc	扁
pmhx	翩
pmm	骗
pmmc	骗
pmmg	楩
pmmk	骈
pmn	犏
pmnc	犏
pmng	㛹
pmo	胼
pmok	胼
pmpv	片
pmr	偏
pmrc	偏
pmrg	便
pmtc	𡎚
pmv	篇
pmvc	篇
pmy	谝
pmz	蹁
pmzc	蹁
pn	票
pnc	薸
pncx	薸
pnd	漂
pndx	漂
pndz	殍
pni	螵
pnix	螵
pnk	嘌
pnkx	嘌
pnm	朴
pnmb	朴
pnmx	骠
pnn	嫖
pnnx	嫖
pno	瞟
pnox	瞟
pns	缥
pnsx	缥
pnx	飘
pnxd	剽
pnxg	瓢
pnxx	飘
po	破
pob	魄
pobg	魄
pobt	皤
pod	泼
podb	泊
podd	泼
podn	婆
poe	陂
poey	陂
poj	钋
pojd	䥽
pojk	钷
pok	叵
pokk	叵
pokz	哱
pom	粕
pomb	朴
pop	鄱
pope	鄱
popx	繁
pot	坡
poty	坡
pou	破
pouy	破
pov	颇
povk	笸
povr	颇
pow	珀
powb	珀
poyd	酦
poz	迫
pozb	迫
pp	撇
ppc	苤
ppca	苤
ppcp	苤
ppd	瞥
ppdo	瞥
ppf	撇
ppfw	撇
ppjw	𬭯
ppq	氕
ppqp	氕
pu	普
pub	匍
pubf	匍
pubo	普
puc	葡
pucf	蒲
pucf	莆
puck	菩
pud	瀑
pudc	溥
pudf	浦
pudn	濮
pudo	潽
pudu	瀑
puf	扑
pufb	扑
puh	穙
puhn	穙
puj	铺
pujn	镤
pujo	镨
puk	噗
pukf	圃
pukn	噗
pum	朴
pumb	朴
pumo	氆
puo	曝
puof	脯
puou	暴
pur	仆
purb	仆
purt	堡
put	埔
putn	墣
puw	璞
puwn	璞
puy	谱
puyf	酺
puyo	谱
puz	蹼
puzn	蹼
pw	配
pwd	沛
pwdl	淠
pwdr	𬇙
pwe	陪
pwek	陪
pwf	裴
pwfl	旆
pwfy	裴
pwj	帔
pwjk	锫
pwjy	帔
pwk	赔
pwka	呸
pwkk	赔
pwkp	呸
pwo	胚
pwoa	胚
pwop	胚
pwr	佩
pwrj	佩
pws	辔
pwsk	辔
pwt	培
pwtk	培
pwxb	衃
pwy	霈
pwyk	醅
pwyl	霈
pz	剖
pzf	抔
pzfb	抔
pzfk	掊
pzl	剖
pzld	剖
pzmk	棓
pzt	垺
pztz	垺
pzw	裒
pzwy	裒
q	去
q	期
qb	亲
qbb	寝
qbby	寝
qbc	芹
qbcj	芹
qbcv	芩
qbd	沁
qbdh	溱
qbdx	沁
qbe	嵚
qbf	秦
qbfd	擒
qbfh	秦
qbfr	揿
qbga	廑
qbgr	𫷷
qbi	螓
qbih	螓
qbj	钦
qbjr	钦
qbjy	锓
qbk	噙
qbkd	噙
qbkh	嗪
qbm	檎
qbmd	檎
qbmy	骎
qbn	勤
qbr	侵
qbrd	禽
qbry	衾
qbs	矜
qbw	琴
qbwv	琴
qbx	覃
qbxa	慬
qbxu	覃
qi	其
qi	弃
qia	七
qiab	鲯
qiad	戚
qiae	郪
qian	妻
qiao	鳍
qiav	七
qic	蕲
qic	芑
qicb	萁
qice	葺
qick	䓫
qicl	荠
qicn	萋
qicu	芪
qid	柒
qid	漆
qidb	淇
qidd	沏
qidk	奇
qidl	泣
qidn	凄
qidq	汽
qie	岂
qiej	屺
qiek	崎
qiel	亓
qiey	岐
qif	旗
qifb	旗
qifd	契
qifv	揭
qig	麒
qigb	麒
qih	启
qihm	棨
qihx	綮
qii	蛴
qiib	蜞
qij	颀
qijk	锜
qijr	颀
qik	器
qikk	器
qikx	嘁
qil	耆
qila	亟
qim	骑
qim	棋
qimb	骐
qimj	杞
qimx	栖
qink	婍
qio	脐
qiol	脐
qip	气
qip	祈
qipb	祺
qipe	祁
qipv	乞
qiq	欺
qiq	憩
qiqb	其
qiqo	期
qiqx	綦
qir	企
qirv	企
qiry	伎
qis	绮
qisk	绮
qit	起
qitj	圻
qitt	畦
qiu	砌
qiud	碶
qiue	𨙸
qiuk	呇
qiur	碛
qiux	磜
qiv	歧
qivy	歧
qiw	齐
qiwb	琪
qiwc	弃
qiwk	琦
qiwl	齐
qiwx	戚
qixo	愭
qiy	讫
qiyq	讫
qiz	蹊
qizk	踦
qizq	迄
qizy	跂
qk	请
qka	鲭
qkao	鲭
qkb	顷
qkbr	顷
qkc	擎
qkck	苘
qkcm	檠
qkcu	擎
qkd	清
qkdo	清
qkf	青
qkfo	青
qkg	庆
qkgd	庆
qkh	黥
qki	轻
qkio	蜻
qkko	圊
qklm	亲
qko	晴
qkoo	晴
qkp	卿
qkpe	卿
qkq	氢
qkqg	氢
qkqo	氰
qkr	倾
qkro	倩
qkrr	倾
qkso	𬘬
qku	磬
qkuf	罄
qkuo	碃
qkv	箐
qkvo	箐
qkw	勍
qkx	情
qkxo	情
qkyo	请
ql	强
qlc	蔷
qlci	蔃
qlck	蔷
qlf	抢
qlfv	抢
qlgi	强
qlh	炝
qlhv	炝
qli	蜣
qliv	蜣
qlj	镪
qljc	锵
qljo	锖
qlk	呛
qlkv	呛
qlm	枪
qlmk	樯
qlmv	枪
qln	嫱
qlnk	嫱
qlo	腔
qlog	腔
qlp	襁
qlpg	戕
qlpi	襁
qlr	戗
qlrg	戗
qlt	墙
qltk	墙
qlw	玱
qlwv	玱
qly	羌
qlyg	羟
qlyv	羌
qlz	跄
qlzv	跄
qm	前
qmb	歉
qmb	骞
qmbd	前
qmbr	歉
qmbu	搴
qmc	茜
qmcc	荨
qmco	蒨
qmcq	芊
qmcr	芡
qmcx	茜
qmd	浅
qmdn	牵
qmdo	潜
qmdr	欠
qme	嵌
qmek	岍
qmeq	阡
qmer	嵌
qmf	扦
qmfo	掮
qmfq	扦
qmgr	𫷷
qmh	黔
qmhw	虔
qmi	堑
qmim	椠
qmit	堑
qmix	愆
qmj	钱
qmj	铅
qmjg	钳
qmjj	钱
qmjq	钎
qmjv	钤
qmmq	杄
qmnj	孅
qmnz	犍
qmo	肷
qmor	肷
qmp	千
qmpu	千
qmr	仟
qmra	佥
qmre	伣
qmro	倩
qmrq	仟
qms	缱
qmso	𬘬
qmsq	纤
qmsz	缱
qmtq	圲
qmu	乾
qmun	磏
qmuq	乾
qmv	签
qmva	签
qmx	慊
qmxt	悭
qmy	谦
qmyn	谦
qmyz	谴
qmz	迁
qmzk	遣
qmzq	迁
qn	桥
qna	翘
qnax	翘
qnb	窍
qnc	荞
qncl	荞
qne	峭
qnel	峤
qneo	峭
qnf	撬
qnfm	撬
qng	巧
qngl	鞒
qngo	鞘
qngv	巧
qnhh	燋
qnj	锹
qnjh	锹
qnm	橇
qnmh	樵
qnml	桥
qnmm	橇
qno	瞧
qnoh	瞧
qnoo	睄
qnr	俏
qnrd	劁
qnrl	侨
qnro	俏
qns	缲
qnsm	缲
qnu	壳
qnuf	雀
qnuj	壳
qnul	硚
qnuw	硗
qnw	敲
qnwy	敲
qnx	悄
qnxh	憔
qnxo	悄
qny	乔
qnyh	谯
qnyl	乔
qnyo	诮
qnz	跷
qnzw	跷
qp	且
qpb	窃
qpbd	窃
qpbv	癿
qpc	茄
qpck	茄
qpf	挈
qpfu	挈
qpj	锲
qpjd	锲
qpl	妾
qpla	且
qpln	妾
qpq	切
qpqd	猰
qpr	伽
qprk	伽
qpt	趄
qptq	趄
qpvj	箧
qpx	怯
qpxe	郄
qpxj	惬
qpxs	怯
qq	求
qqa	鳅
qqad	求
qqah	鳅
qqb	酋
qqby	酋
qqc	萩
qqch	萩
qqcj	艽
qqd	龟
qqdh	湫
qqdr	泅
qqg	鞧
qqgy	鞧
qqh	秋
qqhn	鹙
qqi	蚯
qqiv	虬
qqiy	蝤
qqj	丘
qqjk	訄
qqk	囚
qqkq	赇
qqkr	囚
qqm	糗
qqmh	楸
qqmq	糗
qqp	丘
qqpa	丘
qqq	邱
qqqe	邱
qqqj	犰
qqqy	裘
qqr	仇
qqrj	仇
qqrq	俅
qqv	巯
qqw	球
qqwp	璆
qqwq	球
qqz	逑
qqzj	鼽
qqzq	逑
qqzy	遒
qr	全
qra	鬈
qrau	鳈
qrav	鬈
qrb	泉
qrbw	痊
qrc	颧
qrcr	颧
qrcw	荃
qrd	犬
qrdd	犬
qri	蜷
qriv	蜷
qriw	辁
qrj	拳
qrjd	券
qrjw	铨
qrk	圈
qrkv	圈
qrm	权
qrmv	棬
qrmy	权
qrnv	婘
qro	𨟠
qroe	𨟠
qrr	佺
qrrw	全
qrs	绻
qrsv	绻
qrtq	畎
qrv	筌
qrvw	筌
qrw	瑔
qrx	悛
qrxw	悛
qry	劝
qryl	劝
qryw	诠
qryw	醛
qs	穷
qsb	穹
qsbg	穹
qsbl	穷
qsc	茕
qscl	䓖
qscu	茕
qsg	邛
qsge	邛
qsgi	蛩
qsgj	銎
qsn	嬛
qsny	嬛
qsv	筇
qsve	筇
qsw	琼
qswx	琼
qt	却
qt	缺
qtb	瘸
qtc	鹊
qtcn	鹊
qtd	汋
qtf	缺
qtfg	缺
qtfn	缺
qth	炔
qthg	炔
qthn	炔
qtm	阙
qtmf	榷
qtmo	棤
qtmr	阙
qtmt	阕
qto	𨟠
qtoe	𨟠
qtt	却
qtte	却
qtty	埆
qtu	确
qtuf	雀
qtux	悫
qtuy	确
qu	区
qub	癯
qubf	癯
qubl	劬
qubn	鸲
quc	苣
quci	䓛
qucj	苣
qucm	蕖
qucz	蘧
qud	渠
qudf	灈
que	取
quen	娶
queq	𪨰
quex	岖
quey	取
qufm	麹
quh	觑
quhe	觑
quhw	黢
qui	蛆
quii	衢
quiq	蛐
quiy	蠼
quj	鼩
quk	区
qukx	区
qul	曲
qula	曲
qulk	竘
qum	驱
qumq	阒
qums	㭕
quo	瞿
quof	瞿
quok	朐
quom	氍
quos	胠
qup	祛
qups	袪
qut	趣
qute	趋
qutq	坥
quty	趣
quu	屈
quum	磲
quux	躯
quv	龋
quvy	龋
quw	璩
quy	诎
qx	恰
qxc	葜
qxcd	葜
qxd	洽
qxdk	洽
qxf	掐
qxfb	拤
qxfj	掐
qxg	髂
qxgk	髂
qxkk	匼
qxp	袷
qxpk	袷
qxu	卡
qxub	卡
qxx	恰
qxxk	恰
qy	群
qyg	麇
qygh	麇
qykh	囷
qyp	裙
qypk	裙
qyyy	群
qyz	逡
qyzw	逡
r	人
r	入
rc	绕
rcc	荛
rccw	荛
rcf	扰
rcfy	扰
rcm	桡
rcmw	桡
rcn	娆
rcnw	娆
rcs	绕
rcsw	绕
rcu	饶
rcuw	饶
re	热
re	惹
rec	惹
recx	惹
ref	热
refh	热
rek	喏
rekk	喏
rf	任
rf	忍
rfc	荏
rfcr	荏
rfcx	菍
rfd	刃
rfh	稔
rfhx	稔
rfi	轫
rfir	轫
rfn	妊
rfnr	妊
rfp	壬
rfpn	人
rfpr	衽
rfpu	壬
rfq	壬
rfqa	壬
rfr	忍
rfre	仁
rfrr	仞
rfrx	忍
rfs	纫
rfsr	纫
rfu	饪
rfur	饪
rfw	韧
rfwr	韧
rfy	认
rg	仍
rg	扔
rgf	扔
rgfn	扔
rgr	仍
rgrn	仍
rh	让
rhc	蘘
rhcy	蘘
rhdy	瀼
rhf	攘
rhfy	攘
rhh	穰
rhhy	穰
rhk	嚷
rhky	嚷
rhp	禳
rhpy	禳
rhry	儴
rhs	𬙋
rht	壤
rhw	瓤
rhwg	瓤
rhy	让
rhyu	让
ri	日
rik	日
rika	日
rimo	驲
rj	然
rja	髯
rjar	髯
rjc	苒
rjcr	苒
rjd	染
rjh	燃
rjhh	燃
rji	蚺
rjir	蚺
rjl	冉
rjla	冉
rjph	然
rjrx	䎃
ro	若
roc	鄀
rocd	蒻
roce	鄀
roch	爇
rock	若
rog	弱
rogd	弱
ron	婼
ronk	婼
ror	偌
rork	偌
rov	箬
rovk	箬
rr	软
rre	阮
rree	阮
rri	软
rrir	软
rrn	媆
rrnd	媆
rrt	堧
rrtd	堧
rrwe	瓀
rs	容
rsa	融
rsai	融
rsb	冗
rsbj	冗
rsbk	容
rsc	荣
rsce	茸
rsck	蓉
rscm	荣
rsd	溶
rsdk	溶
rse	嵘
rsem	嵘
rsg	戎
rsgu	戎
rsh	熔
rshk	熔
rsi	蝾
rsim	蝾
rsj	镕
rsjk	镕
rsm	榕
rsmk	榕
rsq	狨
rsqu	狨
rss	绒
rssu	绒
rsw	瑢
rswk	瑢
ru	如
ruc	茹
rucc	蓐
ruce	薷
ruck	茹
rud	汝
rudc	溽
rude	濡
rudk	洳
rudn	汝
rui	辱
ruic	辱
ruie	蠕
ruj	铷
ruk	嚅
ruke	嚅
run	如
rune	嬬
runk	如
rup	入
rupc	褥
rupe	襦
rupn	入
rupv	乳
rur	儒
rure	儒
rus	缛
rusc	缛
ruz	孺
ruze	孺
rvc	蕊
rvcn	芮
rvcu	蕤
rvcx	蕊
rvd	汭
rvdn	汭
rvi	蚋
rvin	蚋
rvj	锐
rvje	锐
rvl	睿
rvlo	睿
rvm	枘
rvmn	枘
rvw	瑞
rvwe	瑞
ryd	润
rydw	润
rym	闰
rymw	闰
rz	肉
rzf	揉
rzfm	揉
rzg	鞣
rzgm	鞣
rzim	𫐓
rzm	糅
rznr	肉
rzs	柔
rzsm	柔
rzz	蹂
rzzm	蹂
s	三
s	随
sa	撒
saa	卅
saal	卅
sac	萨
saci	萨
sad	洒
sadu	挲
sadw	潵
sadx	洒
saf	撒
safw	撒
sag	靸
sagj	靸
sal	飒
salx	飒
sao	脎
saom	脎
sar	仨
sars	仨
sc	扫
scb	瘙
scbi	瘙
scd	溞
scf	搔
scfe	扫
scfi	搔
scm	骚
scmi	骚
scmo	梢
scn	嫂
scny	嫂
sco	臊
scom	臊
scs	缫
scsg	缫
scsm	缲
sct	埽
sctj	埽
sd	赛
sda	鳃
sdax	鳃
sdb	塞
sdbr	赛
sdbt	塞
sdk	噻
sdkt	噻
sdo	腮
sdox	腮
sdt	思
sdtx	思
se	色
seb	塞
sebt	塞
sed	涩
sedb	色
sedv	涩
sedx	㴔
seh	穑
sehk	穑
sej	铯
sejb	铯
sem	槭
semx	槭
seu	啬
seuk	啬
sew	瑟
sewb	璱
sf	森
sfmm	森
sg	僧
sgro	僧
shf	搡
shfm	搡
shk	嗓
shkm	嗓
shsy	𬙋
shu	丧
shum	磉
shun	丧
shy	桑
shym	桑
shyr	颡
si	四
si	寺
sia	肆
siae	兕
siay	肆
sid	死
sidb	死
side	泗
sidj	澌
sids	汜
sidu	涘
sie	㟃
siek	㟃
sif	撕
sifj	撕
sih	私
sihs	私
sii	厮
siid	厕
siij	蛳
sij	锶
sik	嘶
sika	咝
sike	四
sikk	嗣
sil	耜
sim	驷
sime	驷
simx	楒
sin	姒
sinr	姒
sip	祀
sipj	虒
sips	祀
siq	斯
siqj	斯
sir	似
sirk	伺
sirl	食
sirr	似
siru	俟
sirx	偲
sis	缌
sisn	鸶
sisx	缌
sit	思
sitc	寺
sitx	思
siu	饲
siuk	饲
siv	司
siva	丝
sivk	笥
sivn	鸶
sivv	巳
sj	散
sja	三
sjae	三
sjcw	散
sjdw	潵
sjm	糁
sjmp	糁
sjr	伞
sjru	伞
sjs	叁
sjsm	毵
sjsp	参
sjss	叁
sju	馓
sjuw	馓
so	所
soc	蓑
socu	莎
socy	蓑
sod	挲
sodn	娑
sodu	挲
sodx	溹
soj	锁
sojr	锁
sok	唆
soko	嗍
sokr	唢
sokw	唆
sokx	嗦
som	梭
somu	桫
somw	梭
soo	睃
soow	睃
sopj	所
sos	缩
sosb	缩
sou	索
soux	索
sov	些
sove	些
sow	琐
sowr	琐
soy	羧
soyw	羧
sr	算
src	蒜
srcx	蒜
srq	狻
srqw	狻
srv	算
srvc	算
sry	酸
sryw	酸
ss	送
ssb	宋
ssbm	宋
ssbr	颂
ssc	菘
sscs	菘
ssd	淞
sse	嵩
ssek	嵩
sses	崧
ssfy	㧐
ssl	竦
sslu	竦
ssm	松
ssms	松
ssn	娀
ssnu	娀
ssr	耸
ssre	耸
ssrx	怂
ssx	忪
ssxs	忪
ssxu	悚
ssy	讼
ssyy	诵
ssz	送
sszt	送
su	苏
sua	稣
suah	稣
sub	塑
subb	宿
subt	塑
subu	窣
suc	蔌
sucb	苏
sucr	蔌
sud	涑
sud	觫
sudo	溯
suf	素
sufx	素
sug	甦
sugu	甦
suj	夙
sujd	夙
suk	嗉
sukx	嗉
sums	骕
sur	俗
surk	俗
surm	僳
surx	傃
susn	鹔
suv	肃
suvd	肃
suvr	簌
sux	粟
suxm	粟
suxx	愫
suy	诉
suy	酥
suyi	诉
suyw	谡
suz	速
suzb	蹜
suzu	速
sv	岁
svc	荽
svcn	荽
svd	濉
svdf	濉
sve	随
sveo	隋
svex	岁
svez	隧
svfz	旞
svg	髓
svgz	髓
svh	穗
svh	燧
svhx	穗
svi	祟
svix	祟
sviz	𫟦
svjz	𬭼
svk	虽
svki	虽
svo	眭
svof	睢
svot	眭
svpz	襚
svs	绥
svsn	绥
svsy	缞
svu	碎
svwz	璲
svyu	谇
svz	遂
svzu	邃
syc	荪
sycx	荪
syf	损
syfr	损
sym	榫
symu	榫
syq	狲
syqx	狲
syr	隼
syru	隼
syv	笋
syvy	笋
syx	飧
syxl	飧
syz	孙
syzx	孙
sz	搜
szc	薮
szcg	蒐
szcw	薮
szd	溲
szdy	溲
szf	擞
szfw	擞
szfy	搜
szgy	廋
szi	螋
sziy	螋
szj	飕
szjy	锼
szk	嗖
szkr	嗽
szku	嗾
szky	嗖
szo	瞍
szoy	瞍
szp	叟
szpy	叟
szu	馊
szuy	馊
szv	艘
szvy	艘
t	他
t	它
ta	她
taa	鳎
taax	鳎
tab	它
tabb	它
tad	溻
tadx	漯
taf	拓
tafu	拓
tafz	挞
tag	鞳
tagk	鞳
taj	铊
tak	嗒
takk	嗒
tam	榻
tamx	阘
tamz	闼
tan	她
tany	她
tap	褟
tapx	褟
taq	獭
taqr	獭
tar	他
tary	他
tat	塌
tatk	塔
tatx	塌
tau	沓
tauo	沓
taz	踏
taz	遢
tazj	趿
tazo	踏
tazx	蹋
tc	套
tc	淘
tcc	萄
tccf	萄
tcd	涛
tcdd	洮
tcdf	淘
tcdj	滔
tcds	套
tce	陶
tcef	陶
tcey	鼗
tcf	掏
tcff	掏
tcfh	焘
tcg	弢
tcgy	弢
tck	啕
tckd	叨
tckf	啕
tckl	饕
tcm	桃
tcmc	梼
tcmd	桃
tcmf	𫘦
tcs	绦
tcsf	绹
tcsm	绦
tcw	韬
tcwj	韬
tcxj	慆
tcy	讨
tcz	逃
tczd	逃
td	太
tda	鲐
tdak	鲐
tdc	苔
tdck	苔
tdct	薹
tdd	汰
tddd	太
tddt	汰
tdf	抬
tdfk	抬
tdfu	泰
tdj	钛
tdjt	钛
tdk	呔
tdkt	呔
tdm	骀
tdmk	骀
tdo	胎
tdok	胎
tdot	肽
tds	台
tdse	邰
tdsh	炱
tdsk	台
tdt	态
tdtx	态
tdy	酞
tdyt	酞
tdz	跆
tdzk	跆
te	特
tej	铽
tek	慝
tekx	慝
ten	特
tenc	特
tex	忑
texx	忑
tey	忒
teyx	忒
tg	腾
tg	疼
tgb	疼
tgbd	疼
tgc	藤
tgcu	藤
tgh	熥
tghz	熥
tgj	誊
tgjk	誊
tgo	滕
tgoa	䲢
tgoi	螣
tgom	腾
tgou	滕
tgox	縢
th	汤
thd	烫
thdh	烫
thdk	淌
thdp	汤
thf	搪
thfk	搪
thg	唐
thge	鄌
thgk	唐
thi	螳
thik	螗
thit	螳
thj	镗
thje	镋
thjt	镗
thk	嘡
thkt	嘡
thlk	耥
thm	糖
thmk	糖
thmt	樘
thn	帑
thnj	帑
tho	膛
thot	膛
thr	倘
thre	傥
thrk	倘
tht	趟
thtk	塘
thu	躺
thuk	躺
thw	瑭
thwk	瑭
thx	堂
thxe	䣘
thxk	惝
thxm	棠
thxt	堂
thy	羰
thz	蹚
thzt	蹚
ti	体
ti	替
tia	鳀
tiar	鳀
tib	剃
tibd	剃
tibn	鹈
tic	荑
ticy	荑
tid	涕
tidp	涕
tif	提
tifo	替
tifr	提
tifz	擿
tij	锑
tik	啼
tik	嚏
tikj	啼
tim	梯
timn	棣
timp	梯
timr	𫘨
tin	媞
tinj	媂
tinr	媞
tio	题
tiod	剔
tiop	䏲
tior	题
tip	裼
tipn	䴘
tipr	禔
tipw	裼
tir	倜
tirb	体
tirk	倜
tiry	俶
tis	缇
tisp	绨
tisr	缇
titf	趯
tiu	屉
tiuu	屉
tiwr	瑅
tix	悌
tixw	惕
tiy	醍
tiz	踢
tizh	逖
tizj	蹄
tizw	踢
tj	谈
tjb	瘫
tjbf	瘫
tjbh	痰
tjch	菼
tjd	滩
tjdf	滩
tjdk	澹
tjdu	潭
tje	炭
tjeh	炭
tjf	摊
tjff	摊
tjfm	探
tjg	弹
tjgl	弹
tjh	郯
tjj	钽
tjjd	钽
tjjh	锬
tjju	镡
tjk	叹
tjkl	啴
tjky	叹
tjm	毯
tjmd	檀
tjmh	毯
tjmt	榃
tjo	昙
tjos	昙
tjp	袒
tjr	贪
tjrh	倓
tjt	坦
tjtd	坍
tjts	坛
tju	碳
tjux	忐
tjwd	璮
tjx	覃
tjxh	惔
tjy	谭
tk	听
tkc	葶
tkcd	葶
tkcz	莛
tkd	汀
tkdd	渟
tkf	挺
tkfz	挺
tkg	庭
tkgz	庭
tkh	烃
tkhg	烃
tki	厅
tkid	厅
tkiz	蜓
tkj	铤
tkjz	铤
tkk	听
tkm	梃
tkmw	桯
tkmz	梃
tkn	婷
tknd	婷
tkr	停
tkrd	停
tkrr	颋
tkrz	侹
tks	𬘩
tksz	𬘩
tkt	町
tktd	圢
tkv	艇
tkvz	艇
tkw	亭
tkwd	亭
tkwz	珽
tky	霆
tkz	廷
tkzr	廷
tm	天
tm	舔
tmad	天
tmck	黇
tmd	添
tmdb	淟
tmdk	湉
tmdp	殄
tmdt	沺
tmdx	添
tmf	掭
tmfx	掭
tmj	钿
tmjt	钿
tmk	田
tmku	田
tmm	阗
tmmb	阗
tmo	腆
tmob	晪
tmod	盷
tmq	甜
tmqg	甜
tmqx	舔
tmr	佃
tmrt	佃
tmt	填
tmtb	填
tmtw	畋
tmtx	忝
tmx	恬
tn	调
tna	鲦
tnak	髫
tnam	鲦
tnb	窕
tnbd	窕
tnc	苕
tnck	苕
tnf	挑
tnfd	挑
tni	蜩
tnik	蜩
tnim	粜
tnkk	啁
tnkx	㕮
tnn	嬥
tnnf	嬥
tno	眺
tnod	朓
tnp	祧
tnpd	祧
tnr	佻
tnrd	佻
tnv	龆
tnvk	笤
tnw	条
tnwm	条
tnyk	调
tnz	跳
tnzd	跳
tnzk	迢
to	托
toa	橐
toab	𬶍
toam	橐
tocl	萚
tod	沱
todb	沱
toe	陀
toeb	陀
tof	拖
tof	拓
tofq	托
tofy	拖
tog	庹
togi	庹
toj	铊
tojb	铊
tok	唾
tokd	鼍
toki	唾
tokl	啴
tom	驼
tom	椭
tomb	柁
tomd	驮
tomi	柝
ton	鸵
tonb	鸵
too	脱
tooe	脱
top	妥
topn	妥
tor	佗
torb	佗
torq	侂
tot	坨
totb	坨
tou	砣
toub	砣
tov	箨
tovl	箨
toy	酡
toyb	酡
toz	跎
tozb	跎
tp	贴
tpc	萜
tpck	萜
tpd	餮
tpdl	餮
tpj	铁
tpjk	帖
tpju	铁
tpkk	贴
tr	团
trd	湍
trde	湍
trf	抟
trfe	揣
trfv	抟
trhe	煓
trk	团
trkc	团
trqe	猯
trt	疃
trtl	疃
trv	彖
trvu	彖
ts	同
ts	通
tsa	鲖
tsak	鲖
tsb	痛
tsby	痛
tsc	茼
tsck	茼
tsd	彤
tsdl	潼
tse	峒
tsed	峂
tsek	峒
tsf	捅
tsfy	捅
tshk	烔
tshl	穜
tsj	铜
tsk	嗵
tskz	嗵
tsl	童
tsll	童
tslx	𦒍
tsm	桶
tsm	桐
tsml	橦
tsmy	桶
tso	瞳
tsol	曈
tsr	侗
tsrd	佟
tsrg	仝
tsrk	侗
tsrl	僮
tss	统
tsse	统
tst	垌
tstk	垌
tsug	砼
tsv	筒
tsvk	筒
tsx	恸
tsy	酮
tsyk	𫍣
tsz	通
tszy	通
tu	图
tub	突
tubq	突
tuc	荼
tucd	菟
tuch	荼
tucq	葖
tud	涂
tudd	兔
tuh	秃
tuhh	稌
tuhj	秃
tui	徒
tuir	徒
tuj	钍
tuk	吐
tukt	吐
tul	凸
tula	凸
tum	𬳿
tumh	梌
tuo	腯
tuoo	腯
tut	堍
tutd	堍
tuu	土
tuuo	屠
tuwk	㻬
tuy	酴
tuz	途
tv	推
tv	退
tver	𬯎
tvf	推
tvff	推
tvgf	魋
tvh	颓
tvi	蜕
tvo	腿
tvoz	腿
tvp	褪
tvpz	褪
tvy	忒
tvyx	忒
tvz	退
tvzg	退
tya	屯
tyat	鲀
tyav	屯
tyhz	焞
tyk	囤
tykt	囤
tyo	豚
tyou	豚
tyow	暾
typ	褪
typz	褪
tyt	吞
tytk	吞
tytt	坉
tyu	臀
tyuo	臀
tyut	饨
tz	头
tzf	投
tzfy	投
tzg	骰
tzgy	骰
tzr	偷
tzrd	偷
tzz	透
tzzn	透
u	是
u	十
ua	啥
uab	痧
uac	莎
uacu	莎
uad	沙
uada	鲨
uadh	煞
uady	裟
uai	厦
uaiw	厦
uaj	铩
uajm	铩
uak	嗄
uakk	啥
uakn	唼
uakw	嗄
uam	杉
uaq	歃
uaqr	歃
uar	傻
uarw	傻
uas	纱
uasu	纱
uau	砂
uauu	砂
uax	杀
uaxd	刹
uaxm	杀
uay	霎
uayn	霎
uc	少
ucb	勺
ucbd	勺
ucc	苕
ucck	苕
uccu	芍
ucd	邵
ucde	邵
ucdk	召
ucdl	劭
ucdo	潲
ucf	捎
ucfo	捎
ucg	鞘
uch	稍
uchw	烧
uck	哨
ucko	哨
ucl	韶
uclk	韶
ucm	梢
ucmk	柖
ucmo	梢
ucmu	杓
uco	睄
ucoo	睄
ucs	绍
ucsk	绍
ucv	艄
ucwk	玿
ucx	少
ud	晒
udd	色
uddb	色
udo	晒
udox	晒
udv	筛
udvj	筛
udy	酾
udyl	酾
ue	设
ued	涉
uedo	奢
uedp	涉
uedx	奓
uedy	滠
uee	𪨶
ueei	𪨶
uef	摄
uefj	折
uefy	摄
ueg	麝
uegc	麝
uei	蛇
uei	厍
ueib	蛇
uek	赊
uekx	赊
uem	阇
uemo	阇
uep	社
uept	社
ueq	舌
ueqk	猞
uer	舍
uerk	舍
uerr	歙
uert	畲
uerx	佘
uet	赦
uetw	赦
ueu	射
ueuc	射
uex	慑
uexy	慑
ueyy	设
uf	深
ufap	鲹
ufb	审
ufbp	瘆
ufbu	审
ufc	莘
ufcu	莘
ufcv	葚
ufd	沈
ufdp	渗
ufdv	沈
ufee	屾
ufhm	燊
ufi	蜃
ufii	蜃
ufju	𬬹
ufk	呻
ufku	呻
ufkx	哂
ufl	申
ufll	申
uflo	肾
ufm	糁
ufmp	糁
ufmv	椹
ufn	婶
ufnn	娠
ufnu	婶
ufo	胂
ufou	瞫
ufp	身
ufpp	身
ufpu	神
ufq	甚
ufr	什
ufr	伸
ufre	侁
ufs	参
ufs	绅
ufsp	参
ufu	砷
uful	矧
ufuy	矧
ufw	珅
ufx	慎
ufyv	谌
ufyx	谂
ug	生
ug	省
ugd	渑
uge	嵊
uget	陞
ugi	盛
ugim	盛
ugn	牲
ugo	胜
ugoi	晟
ugou	昇
ugp	升
ugpc	升
ugpf	生
ugq	剩
ugqd	剩
ugqn	乘
ugs	绳
ugsd	绳
ugu	声
ugul	甥
uguo	省
ugup	声
ugv	笙
ugvu	笙
ugy	圣
uh	上
uhd	殇
uhdp	觞
uhh	熵
uhla	上
uho	晌
uhok	晌
uhr	伤
uhrl	伤
uhs	绱
uhsk	绱
uht	墒
uhtk	垧
uhw	商
uhwk	商
uhx	尚
uhx	裳
uhxr	赏
ui	时
ui	室
uia	事
uiac	鲥
uiai	鲺
uiaj	𫚕
uiak	石
uial	十
uian	豕
uiav	世
uib	实
uibt	室
uic	蓍
uicc	莳
uid	湿
uidb	奭
uidq	殖
uidy	湿
uie	示
uiec	峙
uiex	示
uif	拾
uifg	拭
uifk	誓
uifl	势
uify	施
uii	轼
uijj	铈
uik	嗜
uika	噬
uiko	啫
uikr	噬
uiky	嘘
uil	师
uilj	师
uiln	史
uim	驶
uimg	栻
uimj	柿
uin	始
uink	始
uio	匙
uiob	匙
uioc	时
uior	是
uiox	䏡
uip	视
uipe	视
uipf	失
uipl	释
uipt	矢
uipv	氏
uiq	狮
uiq	舐
uiqj	狮
uir	使
uirc	侍
uirl	食
uirr	似
uiru	仕
uiru	什
uit	螫
uitc	埘
uite	邿
uiu	蚀
uiua	士
uiuj	饰
uium	屎
uiun	鸤
uiur	贳
uiv	尸
uiv	虱
uivp	尸
uivr	筮
uiw	市
uix	恃
uixc	恃
uixg	弑
uiy	式
uiyb	识
uiyc	诗
uiyg	试
uiyl	酾
uiym	谥
uiyr	𬤊
uiz	适
uizj	逝
uizk	适
uj	山
uja	鳝
ujad	鳣
ujak	鳝
ujb	单
ujbe	疝
ujbl	单
ujc	删
ujcd	删
ujck	苫
ujd	汕
ujd	潸
ujde	汕
uje	陕
ujej	陕
ujek	嶦
ujf	擅
ujfd	擅
ujfh	掞
ujfl	掸
ujfp	掺
ujh	扇
ujhd	剡
ujhx	煽
uji	蟮
ujik	蟮
ujj	钐
ujjp	钐
ujk	赡
ujkk	赡
ujlk	山
ujm	闪
ujmc	栅
ujmp	杉
ujmx	骟
ujn	姗
ujnc	姗
ujnd	嬗
ujo	膳
ujod	膻
ujoh	晱
ujok	膳
ujp	衫
ujpl	禅
ujpp	衫
ujs	缮
ujsk	缮
ujtk	墡
ujtl	𫮃
ujv	舢
ujw	珊
ujwc	珊
ujy	善
ujye	讪
ujz	跚
ujzc	跚
uk	帅
ukf	摔
ukfu	摔
uki	蟀
ukk	甩
ukkv	甩
uklj	帅
uksy	缞
ukw	衰
ukwu	率
ukwy	衰
ul	双
ula	爽
ulan	爽
uld	爽
uldl	泷
uldx	爽
ulmo	骦
uln	孀
ulno	孀
uluo	礵
uly	霜
ulyn	鹴
ulyo	霜
ulyy	双
uo	说
uob	朔
uobm	槊
uobo	朔
uoc	蒴
uof	搠
uofo	搠
uoh	烁
uoj	铄
uojl	铄
uon	妁
uonu	妁
uou	硕
uour	硕
uoy	说
uoye	说
ur	拴
urd	涮
urdd	涮
urfw	拴
urm	闩
urma	闩
urmw	栓
uro	腨
uroe	腨
uu	数
uua	束
uuad	戍
uuan	束
uuc	薯
uuco	薯
uucv	蔬
uucy	菽
uud	殊
uud	沭
uudr	漱
uudv	殊
uudy	淑
uuev	陎
uuf	抒
uufl	抒
uufx	摅
uug	庶
uugh	庶
uuh	黍
uuhh	稌
uui	输
uuj	鼠
uujv	鼠
uuk	赎
uukd	赎
uul	竖
uult	墅
uum	树
uumc	树
uumd	术
uumv	梳
uumx	枢
uun	恕
uun	姝
uunx	恕
uuny	婌
uuo	暑
uuod	腧
uuoo	曙
uur	舒
uur	倏
uure	鄃
uurl	舒
uurm	毹
uurx	悆
uus	署
uusi	蜀
uusl	纾
uuso	署
uuu	属
uuuy	叔
uuv	书
uuvv	疏
uuw	熟
uuwd	戍
uuwh	熟
uuwt	塾
uuww	孰
uuwy	琡
uuz	述
uv	水
uvh	税
uvhe	税
uvje	帨
uvln	水
uvo	睡
uvoi	睡
uvy	谁
uvye	说
uw	谁
uwy	谁
uwyf	谁
uxe	耍
uxen	耍
uxk	唰
uxkd	唰
uxu	刷
uxud	刷
uy	顺
uyi	顺
uyir	顺
uyk	吮
uyke	吮
uym	楯
uymo	楯
uyo	瞬
uyol	瞬
uyp	舜
uypl	舜
uz	受
uz	守
uzb	首
uzbc	守
uzbk	兽
uzby	瘦
uzbz	首
uzf	授
uzfc	寿
uzfy	授
uzp	手
uzpl	手
uzpy	受
uzq	狩
uzqc	狩
uzr	售
uzrk	售
uzs	绶
uzv	收
uzvw	收
uzvz	艏
uzw	熟
v	这
v	之
va	扎
vaa	鲊
vaav	鲊
vab	痄
vabv	痄
vad	渣
vadd	渣
vadg	溠
vadx	奓
vaf	揸
vafd	揸
vafq	挓
vafv	扎
vah	炸
vai	轧
vaiv	蚱
vaj	铡
vajd	铡
vak	喳
vakj	哳
vakm	喋
vakq	咤
vakv	咋
vam	榨
vamc	栅
vamd	查
vamd	楂
vamj	闸
vamv	札
vao	眨
vaof	眨
vap	乍
vapa	乍
vaq	猹
vaqd	猹
vau	砟
vauv	砟
vaux	䃎
vav	劄
vavd	劄
vax	怍
vaxv	怍
vay	诈
vaya	鲝
vayv	诈
vaz	齇
vazq	齇
vc	找
vc	招
vca	𬶐
vcav	𬶐
vcd	召
vcdk	沼
vce	兆
vced	兆
vcf	招
vcfd	旐
vcfk	招
vch	肇
vcj	钊
vcjd	钊
vcjk	𬬿
vck	嘲
vckk	啁
vcko	嘲
vcm	棹
vco	照
vcog	曌
vcoh	照
vcok	昭
vcp	爪
vcpn	爪
vcs	罩
vcsu	罩
vct	赵
vctx	赵
vcu	朝
vcv	笊
vcy	诏
vcyo	着
vdb	窄
vdbm	寨
vdbq	宅
vdbx	瘵
vdf	摘
vdfk	摘
vdfl	择
vdfz	擿
vdp	祭
vdpx	祭
vdr	债
vdrd	侧
vdrr	债
vdv	砦
vdw	斋
vdwe	斋
vdx	翟
vdxf	翟
ve	着
vec	蔗
vech	蔗
ved	浙
vedj	浙
vef	折
vefi	蛰
vefi	蜇
vefk	哲
vefo	晢
veg	鹧
vegi	䗪
vegn	鹧
vei	辙
veiv	辄
veiw	辙
vej	锗
vejo	锗
vek	啫
veko	啫
vel	者
velk	詟
velo	者
vem	柘
vemu	柘
vep	褶
vepb	褶
vepo	褚
vet	赭
veti	螫
veto	赭
veu	喆
veuk	喆
veum	磔
vey	谪
veyk	谪
veyo	着
vez	遮
vezh	遮
vezw	这
vf	真
vfa	臻
vfab	鬒
vfah	臻
vfb	疹
vfc	蓁
vfck	葴
vfd	溱
vfdn	鸩
vfe	阵
vfei	阵
vff	振
vffn	振
vffv	揕
vfh	稹
vfhb	稹
vfi	轸
vfip	轸
vfj	镇
vfjr	帧
vfju	针
vfk	赈
vfkn	赈
vfl	贞
vflr	贞
vfm	枕
vfmh	榛
vfmr	桢
vfmv	椹
vfo	朕
vfop	胗
vfot	朕
vfp	祯
vfpp	袗
vfpr	祯
vfq	斟
vfqu	斟
vfr	侦
vfrr	侦
vfs	缜
vfsb	缜
vfsl	纼
vft	圳
vfti	圳
vftp	畛
vfu	砧
vfub	真
vfuk	砧
vfv	箴
vfvk	箴
vfw	珍
vfwb	瑱
vfwp	珍
vfx	甄
vfxw	甄
vfy	震
vfyn	震
vfyp	诊
vg	正
vg	症
vga	正
vgav	正
vgb	郑
vgbe	郑
vgbv	症
vgc	蒸
vgch	蒸
vgd	争
vgdl	争
vge	峥
vgel	峥
vgf	挣
vgf	拯
vgfl	挣
vgi	征
vgiv	征
vgiw	徵
vgj	铮
vgjl	铮
vgjv	钲
vgl	烝
vglh	烝
vgo	睁
vgol	睁
vgq	狰
vgso	𬘬
vgu	整
vgv	政
vgv	筝
vgvw	政
vgx	怔
vgxa	憕
vgxv	怔
vgy	证
vgyl	诤
vgyv	证
vh	长
vha	丈
vhan	丈
vhb	瘴
vhd	涨
vhdi	涨
vhdu	漳
vhe	障
vheu	嶂
vhg	张
vhgi	张
vhi	蟑
vhiu	蟑
vhj	帐
vhji	帐
vhju	幛
vhk	账
vhki	账
vhl	章
vhlp	彰
vhlu	章
vhm	樟
vhmv	杖
vhn	嫜
vhnu	嫜
vho	胀
vhoi	胀
vhou	暲
vhpn	长
vhq	獐
vhqu	獐
vhr	仗
vhrj	仉
vhrv	仗
vhw	璋
vhx	掌
vhxu	掌
vi	只
via	至
viae	郅
viat	至
viaw	致
vib	旨
vibc	痔
vibt	窒
vibx	痣
vic	芝
vicb	𦭜
vicv	芷
vid	治
vid	汁
vidj	滞
vidl	觯
vidn	之
vidq	殖
vidv	沚
vie	职
vieb	职
viec	峙
viem	骘
viep	陟
vif	指
vif	执
vife	掷
vifn	鸷
vifo	指
vifr	贽
vifu	挚
vifx	絷
vifz	擿
vigc	庤
vih	秩
vihf	稚
vihq	稙
vii	咫
viib	轵
viik	蜘
viit	蛭
viiw	徵
vij	帜
vij	帙
vijr	锧
vik	吱
vikb	只
viky	吱
vil	止
vila	止
vile	郦
vim	枝
vim	枳
vime	栉
vimo	榰
vimq	植
vimr	𬃊
vimt	桎
vimv	栀
vimx	梽
vimy	枝
vio	脂
viod	胝
vioo	脂
viot	晊
vioy	肢
vip	制
viph	炙
vipp	豸
vipr	质
vipv	祉
vir	值
virq	值
virt	侄
vis	纸
visb	织
visq	置
visu	纸
vit	址
vitc	畤
vitq	埴
vitv	址
viu	知
viu	智
viuf	雉
viuq	直
viur	疐
viux	志
viuy	支
viv	彘
vivb	彘
vix	忮
viy	识
viyd	黹
viyo	酯
viz	踯
vizr	踬
vizv	趾
vj	占
vj	战
vja	鳣
vjad	鳣
vjc	蘸
vjd	沾
vjd	湛
vjdk	詹
vje	崭
vjej	崭
vjek	嶦
vjev	嵁
vjf	搌
vjfd	旃
vjfn	搌
vji	斩
vjij	斩
vjin	辗
vjj	盏
vjjk	飐
vjl	站
vjlg	战
vjm	粘
vjmd	栴
vjmj	栈
vjmk	毡
vjo	瞻
vjok	瞻
vjr	偡
vjrv	偡
vjs	绽
vjsr	绽
vju	展
vjud	𫗴
vjun	展
vjw	颤
vjwn	鹯
vjwr	颤
vjy	谵
vjyk	谵
vk	拽
vkf	拽
vkfy	拽
vl	装
vld	壮
vldn	妆
vldq	状
vldx	漴
vldy	装
vlf	撞
vlfl	撞
vlg	庄
vlgt	庄
vlj	幢
vljl	幢
vll	戆
vllx	戆
vlm	桩
vlmt	桩
vlp	奘
vlpd	奘
vlr	僮
vlrl	僮
vlv	奘
vlvd	奘
vo	桌
voc	茁
voci	茁
voco	著
vocu	䓬
vod	浊
vodf	濯
vodi	浊
vodn	涿
vodr	浞
vodu	淖
vof	捉
voff	擢
vofi	拙
vofn	𬸦
vofr	捉
voh	灼
vohh	燋
vohu	焯
voj	镯
voji	镯
vojo	䦃
vok	啄
vokn	啄
vol	卓
volm	桌
vom	棹
vome	棁
vomn	椓
vomu	棹
voo	晫
voou	晫
vop	禚
voph	禚
vor	倬
voru	倬
vos	缴
vosw	缴
vou	斫
vouj	斫
vow	琢
vown	琢
voy	酌
voyn	诼
voyo	着
voyu	酌
voyy	叕
vr	转
vra	专
vrad	专
vre	颛
vrf	撰
vrfb	撰
vri	转
vriv	转
vrk	赚
vrkn	赚
vrkv	啭
vro	䏝
vrov	䏝
vrr	传
vrrb	僎
vrrv	传
vru	砖
vrub	馔
vruv	砖
vrv	篆
vrwu	瑑
vs	中
vs	终
vsb	冢
vscv	茽
vsh	种
vshl	穜
vshv	种
vsi	蚣
vsis	蚣
vsj	钟
vsjv	锺
vsmd	柊
vso	肿
vsov	肿
vsp	重
vspa	重
vsr	众
vsrr	众
vsrv	仲
vss	终
vssd	终
vsv	忠
vsvm	盅
vsvx	忠
vsw	衷
vswi	螽
vswy	衷
vsxs	忪
vsz	踵
vszv	踵
vu	主
vubn	瘃
vubv	疰
vuc	著
vuca	苎
vucd	苧
vuco	著
vucv	茱
vud	注
vud	渚
vudv	洙
vuf	拄
vufv	拄
vug	竹
vugv	麈
vuh	烛
vuhi	烛
vuhv	炷
vui	蛛
vuiv	蛀
vuj	铸
vujc	铸
vujv	铢
vuk	嘱
vuka	贮
vuky	嘱
vul	煮
vulh	煮
vulx	翥
vum	驻
vum	株
vumd	术
vume	柷
vuml	杼
vumo	槠
vumv	柱
vun	朱
vunn	朱
vuo	瞩
vuoy	瞩
vup	祝
vupe	祝
vupl	竹
vupo	褚
vupw	朱
vuq	猪
vuql	助
vuqo	猪
vur	住
vura	伫
vurv	侏
vus	纻
vusa	纻
vuuv	砫
vuuy	属
vuv	筑
vuve	竺
vuvo	箸
vuvy	舳
vuw	珠
vuwv	珠
vuy	诸
vuyo	诸
vuyv	诛
vuz	逐
vuzi	躅
vv	追
vve	坠
vvet	坠
vvf	赘
vvfe	揣
vvfr	赘
vvj	锥
vvjf	锥
vvm	椎
vvmf	骓
vvr	隹
vvs	缀
vvsy	缀
vvsz	缒
vvx	惴
vvxe	惴
vvz	追
vvzk	追
vwz	这
vwzw	这
vx	抓
vxa	髽
vxat	髽
vxf	挝
vxfv	抓
vxfz	挝
vxp	爪
vxpn	爪
vya	屯
vyav	屯
vybt	窀
vyd	准
vydf	准
vydz	淳
vyi	衠
vyii	衠
vyo	肫
vyot	肫
vysz	𬘯
vytq	圫
vyxt	忳
vyy	谆
vyyz	谆
vz	周
vzb	宙
vzby	宙
vzc	荮
vzcc	荮
vzd	州
vzdl	洲
vzdv	洲
vzdy	皱
vze	帚
vzej	帚
vzg	粥
vzgg	粥
vzi	轴
vzid	昼
vziv	辀
vziy	轴
vzk	咒
vzkk	啁
vzm	骤
vzmk	椆
vzmn	骤
vzn	妯
vznk	婤
vzny	妯
vzo	肘
vzoc	肘
vzp	舟
vzpd	舟
vzre	㑇
vzs	绉
vzsc	纣
vzse	绉
vzu	碡
vzum	碡
vzv	籀
vzvn	鸼
vzvt	籀
vzx	㤘
vzxe	㤘
vzy	诌
vzyc	酎
vzyo	胄
w	我
w	位
wa	挖
waa	瓦
waad	瓦
wabg	窊
wad	洼
wadt	洼
wafv	挖
wai	蛙
wait	蛙
wak	哇
wakn	呙
wakt	哇
wal	凹
wan	娃
wank	婠
wann	娲
want	娃
wao	腽
waom	腽
wap	袜
war	佤
warw	佤
wat	畖
watg	畖
wd	外
wdb	歪
wdbv	歪
wde	崴
wden	崴
wdkn	呙
wdp	歪
wdpv	歪
wf	问
wf	文
wfa	鳁
wfam	鳁
wfb	瘟
wfcw	芠
wfd	温
wfdm	温
wfdw	汶
wff	揾
wffm	揾
wfh	稳
wfhw	炆
wfi	蚊
wfim	辒
wfiw	蚊
wfk	吻
wfkw	吻
wfm	闻
wfme	闻
wfmm	榅
wfmw	𫘜
wfmy	阌
wfp	璺
wfpy	璺
wfs	纹
wfsm	缊
wfsw	纹
wfw	文
wfwd	刎
wfwm	韫
wfww	玟
wfwx	紊
wfy	雯
wfyw	雯
wg	翁
wgb	瓮
wgbn	鹟
wgbw	瓮
wgbx	翁
wgc	蓊
wgcf	蕹
wgcx	蓊
wgdx	滃
wgjx	𬭩
wgk	嗡
wgkx	嗡
wh	王
wh	忘
wha	王
what	王
whd	汪
whdw	汪
whg	魍
whgw	魍
whi	往
whiv	往
whiw	辋
whk	网
whkw	罔
whkx	网
whm	枉
whmw	枉
who	旺
whow	旺
whuw	尪
whw	望
whwn	妄
whwv	亡
whwx	忘
whx	惘
whxw	惘
wj	完
wj	玩
wja	万
wjap	万
wjav	豌
wjb	皖
wjbd	剜
wjbe	皖
wjbv	宛
wjc	莞
wjce	莞
wjcv	菀
wjcw	芄
wjcy	蔓
wjd	湾
wjdg	湾
wjdv	涴
wjdw	𬇕
wje	顽
wjf	挽
wjfv	挽
wjh	烷
wjhe	烷
wji	蜿
wjiv	蜿
wjmv	椀
wjn	婉
wjne	妧
wjnk	婠
wjnv	婉
wjo	晚
wjoe	脘
wjov	腕
wjp	丸
wjpd	丸
wjs	纨
wjse	𬘫
wjsk	绾
wjsw	纨
wjt	畹
wjtg	塆
wjtv	畹
wju	碗
wjuv	碗
wjva	毌
wjw	玩
wjwe	玩
wjwg	弯
wjwv	琬
wjx	惋
wjxv	惋
wo	握
wob	窝
wobn	窝
woc	莴
wocn	莴
wod	沃
wodn	涡
wodt	渥
wodv	涴
wody	沃
wof	挝
woft	握
wofz	挝
woh	馧
wohm	馧
woi	卧
woib	卧
woin	蜗
woj	幄
wojt	幄
wok	喔
wokn	呙
wokt	喔
woo	肟
wook	肟
wop	我
wopd	我
wor	倭
worn	倭
wort	偓
wou	斡
wouu	斡
wouw	硪
wov	龌
wovt	龌
woz	踒
wozn	踒
wu	无
wua	五
wuaa	五
wuad	戊
wuae	兀
wuan	鹉
wuav	武
wuay	无
wub	勿
wubk	寤
wubp	勿
wuc	芜
wucw	芴
wud	污
wudv	洿
wudw	𣲘
wue	屼
wuek	峿
wuew	屼
wuf	捂
wufd	於
wufk	捂
wug	巫
wugn	鹀
wugp	戊
wugw	庑
wuh	焐
wuhk	焐
wui	蜈
wuit	蜈
wuj	钨
wujw	钨
wuk	吴
wukk	唔
wukt	吴
wukw	呜
wum	梧
wun	物
wunk	牾
wunw	妩
wuo	晤
wuok	晤
wuow	旿
wup	舞
wupa	乌
wupg	午
wupl	舞
wur	伍
wurm	侮
wurw	仵
wus	婺
wusm	骛
wusn	鹜
wut	圬
wutw	坞
wuu	屋
wuut	屋
wuv	毋
wuva	毋
wuw	务
wuwe	邬
wuwk	吾
wuwl	务
wuwv	珷
wux	悟
wuxw	忤
wuy	误
wuy	诬
wuyl	雾
wuyx	恶
wuz	迕
ww	为
wwa	未
wwac	鳚
wwad	威
wwal	韦
wwao	鲔
wwav	𬶏
wwb	痿
wwbn	痿
wwc	薇
wwc	葳
wwcc	蔚
wwcn	萎
wwcw	苇
wwcz	薳
wwd	危
wwdf	潍
wwdo	渭
wwdr	𬱟
wwdv	洈
wwdw	涠
wwe	巍
wwea	卫
wweg	隗
wwen	崴
wwfw	㧑
wwgg	廆
wwh	委
wwhg	魏
wwhn	煨
wwhw	炜
wwi	微
wwiw	微
wwj	帷
wwje	𬭬
wwjf	帷
wwjw	帏
wwk	味
wwkf	唯
wwkn	喂
wwkw	围
wwm	闱
wwmv	桅
wwn	娓
wwo	韪
wwow	𬀩
wwq	猥
wwqn	猥
wwqo	猬
wwr	伟
wwrl	位
wwrn	偎
wwrw	伪
wws	维
wwsf	维
wwsw	纬
wwt	胃
wwt	畏
wwty	圩
wwu	尾
wwuc	尉
wwuj	硙
wwum	尾
wwun	碨
wwux	慰
wwv	卫
wwva	卫
wwvm	艉
www	威
wwwn	威
wwww	玮
wwx	威
wwxf	惟
wwy	谓
wwyc	霨
wwyn	诿
wwyo	谓
wwz	违
wwzn	逶
wwzw	违
x	小
x	性
xb	新
xb	心
xbc	芯
xbcj	薪
xbcu	莘
xbcx	芯
xbd	心
xbgr	𫷷
xbh	炘
xbj	锌
xbjj	鑫
xbjr	欣
xbl	辛
xblj	新
xblr	歆
xbo	昕
xboj	昕
xbp	囟
xbpx	囟
xbr	信
xbrk	信
xbrx	伈
xbu	馨
xbx	衅
xbxj	忻
xi	系
xia	西
xiaa	西
xiab	鳛
xiak	𬶮
xib	兮
xibe	郤
xibv	兮
xibx	窸
xic	昔
xico	昔
xicr	蓰
xicx	茜
xid	洗
xidd	溪
xide	洗
xidh	潟
xidj	淅
xidj	浠
xidk	觿
xidx	汐
xidy	玺
xie	隙
xieb	嶍
xieg	巇
xieh	隰
xiev	嶲
xiex	隙
xig	席
xige	觋
xih	稀
xih	熄
xihd	爔
xihj	烯
xii	熙
xiij	蜥
xiir	徙
xiix	蟋
xij	锡
xijd	鼷
xije	铣
xijw	锡
xik	吸
xikh	熙
xikj	唏
xikk	嘻
xikx	喺
xil	袭
xily	袭
xim	析
ximb	皙
ximd	𫘬
xime	阋
ximj	析
ximn	樨
ximw	檄
ximx	栖
xin	牺
xin	嬉
xinx	媳
xio	膝
xio	晞
xiod	曦
xioj	晰
xiok	暿
xioo	腊
xip	夕
xip	奚
xipk	禧
xipw	裼
xipx	悉
xir	翕
xird	傒
xirk	僖
xirx	翕
xis	细
xisk	绤
xism	枲
xist	细
xiu	喜
xiu	硒
xiuh	熹
xiun	犀
xiuq	饩
xiur	屣
xiv	习
xivd	习
xivx	舾
xiwl	釐
xiwx	𠅤
xix	希
xixe	郗
xixj	希
xixo	惜
xixq	忾
xiy	戏
xiyd	羲
xiyg	戏
xiym	醯
xiz	息
xizd	蹊
xizx	息
xk	行
xk	型
xkc	荇
xkcu	荥
xke	陉
xkeg	陉
xkf	擤
xkfl	擤
xkhu	煋
xkii	行
xkjd	铏
xkk	形
xkkd	刑
xkke	邢
xkkp	形
xkkt	型
xkm	杏
xkn	姓
xknu	姓
xko	星
xkou	腥
xkq	猩
xkt	幸
xktg	幸
xkud	硎
xkuo	省
xkup	饧
xkx	性
xkxb	兴
xkxg	悻
xkxu	惺
xky	醒
xl	想
xlc	巷
xlco	葙
xlcs	巷
xlcx	芗
xld	象
xldn	象
xldo	湘
xle	降
xlel	降
xlg	项
xlgy	庠
xlh	香
xli	厢
xlio	厢
xlj	镶
xlja	鲞
xljy	镶
xlk	响
xlkk	响
xlm	相
xlmn	橡
xlmo	相
xlmx	想
xlmy	骧
xlp	向
xlpk	向
xlpy	祥
xlr	像
xlrn	像
xlry	儴
xls	缃
xlso	缃
xlsy	𬙋
xlu	饷
xluk	饷
xlv	乡
xlvo	箱
xlvp	乡
xlw	享
xlwk	珦
xlwy	襄
xlwz	享
xlx	飨
xly	详
xlyx	翔
xm	先
xma	鲜
xmad	咸
xmay	鲜
xmb	宪
xmbe	宪
xmbm	痫
xmbn	𬸣
xmc	藓
xmc	苋
xmca	莶
xmd	冼
xmdz	涎
xme	限
xme	岘
xmea	险
xmeg	限
xmej	陷
xmf	掀
xmfc	挦
xmfp	掺
xmfr	掀
xmg	弦
xmgy	弦
xmi	衔
xmi	蚬
xmj	铣
xmje	铣
xmjr	锨
xml	贤
xmlr	贤
xmm	闲
xmme	籼
xmmm	闲
xmmn	鹇
xmn	嫌
xmn	娴
xmne	先
xmnj	孅
xmnn	嫌
xmo	显
xmod	盷
xmoe	𪾢
xmoh	㬎
xmou	腺
xmoy	显
xmp	祆
xmpt	祆
xmpu	禒
xmq	县
xmqa	猃
xmqe	氙
xmqs	县
xmqx	狝
xmr	仙
xmre	仙
xmry	伭
xms	线
xmsq	纤
xmsz	𫄧
xmu	献
xmuj	馅
xmuq	献
xmv	舷
xmvy	舷
xmw	现
xmwe	现
xmwk	咸
xmwy	玹
xmx	咸
xmxr	忺
xmy	羡
xmye	酰
xmyk	𫍯
xmyr	羡
xmyw	霰
xmz	跹
xmze	跣
xmzf	暹
xn	笑
xnb	宵
xnbb	皛
xnbo	宵
xnc	萧
xncs	萧
xnd	消
xndo	淆
xnds	潇
xndx	洨
xndz	涍
xne	崤
xneo	崤
xng	魈
xnhk	熇
xni	蛸
xnio	蛸
xnis	蟏
xnj	销
xnjj	虓
xnjo	销
xnk	啸
xnkk	嚣
xnkn	鸮
xnks	啸
xnkw	哓
xnkz	哮
xnl	孝
xnld	小
xnlz	孝
xnm	校
xnm	骁
xnmv	枵
xnmx	校
xnn	姣
xnnx	姣
xno	晓
xnoo	睄
xnow	晓
xnp	枭
xnqj	猇
xnrx	翛
xns	绡
xnu	硝
xnv	箫
xnvw	筱
xnvy	笑
xnw	效
xnx	肖
xnxd	削
xnxo	肖
xnxw	敩
xnxx	恔
xny	霄
xnyo	霄
xnyy	𫍲
xnz	逍
xnzo	逍
xp	些
xpa	鲑
xpat	鲑
xpb	写
xpby	写
xpc	薤
xpcj	薤
xpcn	薢
xpd	泄
xpd	蟹
xpdj	瀣
xpdn	解
xpdt	觟
xpdy	泻
xpf	携
xpfd	契
xpfj	挟
xpfn	携
xpfr	撷
xpfx	絜
xpg	鞋
xpgn	廨
xpgt	鞋
xph	燮
xphy	燮
xpi	蝎
xpiv	蝎
xpk	叶
xpku	叶
xpl	勰
xplx	勰
xpm	械
xpm	榭
xpmd	楔
xpo	歇
xpob	胁
xpor	歇
xpp	血
xppe	卸
xppm	血
xpq	獬
xpqn	獬
xpr	斜
xprb	偕
xprd	偰
xprt	㙦
xps	绁
xpsr	缬
xpsu	绁
xpu	协
xpub	协
xpuo	屑
xpur	颉
xpw	卸
xpwe	卸
xpwy	亵
xpx	懈
xpxn	懈
xpy	谢
xpy	谐
xpye	邪
xpz	邂
xpzn	邂
xpzy	躞
xq	修
xqa	髹
xqam	髹
xqb	宿
xqbb	宿
xqd	溴
xqdo	滫
xqdq	溴
xqe	岫
xqey	岫
xqg	庥
xqgm	庥
xqh	秀
xqhn	秀
xqio	䗛
xqj	锈
xqjn	锈
xqk	嗅
xqkm	咻
xqkq	嗅
xqm	朽
xqmv	朽
xqp	袖
xqpy	袖
xqr	休
xqrm	休
xqrn	鸺
xqro	脩
xqrp	修
xqs	绣
xqsn	绣
xqu	馐
xqv	貅
xqvm	貅
xqw	琇
xqwn	琇
xqwo	珛
xqy	羞
xqz	臭
xqzq	臭
xr	选
xrb	宣
xrbg	宣
xrby	癣
xrc	萱
xrcg	萱
xrd	渲
xrdr	漩
xrdy	泫
xrf	旋
xrfr	旋
xrh	炫
xrhg	煊
xrhy	炫
xri	轩
xrii	衒
xrj	铉
xrjd	券
xrjo	𫓶
xrjy	铉
xrk	喧
xrkg	咺
xrm	楦
xrmg	楦
xrmy	𫠊
xrn	嬛
xrny	嬛
xro	眩
xrog	暄
xror	暶
xroy	昡
xrp	禤
xrpx	禤
xrq	悬
xrqx	悬
xrr	儇
xrry	伭
xrs	绚
xrso	绚
xrsx	翾
xru	碹
xrug	碹
xrw	玄
xrwg	瑄
xrwr	璇
xrwy	玹
xrxg	愃
xry	谖
xs	熊
xs	凶
xsb	匈
xsc	芎
xscg	芎
xsd	汹
xsdk	汹
xsdw	夐
xsk	兄
xske	兄
xso	胸
xsok	胸
xss	熊
xssh	熊
xsu	雄
xsx	凶
xsy	讻
xt	学
xta	鳕
xtae	鳕
xtb	穴
xtbb	穴
xtc	薛
xtcb	茓
xtcu	薛
xtf	踅
xtfr	踅
xtg	靴
xtgb	靴
xtk	噱
xtp	血
xtx	削
xtxe	峃
xtxw	敩
xtxz	学
xty	雪
xty	谑
xu	需
xua	戌
xuad	戌
xuc	蓄
xucb	蓿
xuct	蓄
xud	溆
xudw	浒
xudx	洫
xudy	溆
xug	序
xugl	序
xugv	魆
xuh	虚
xuhy	虚
xui	徐
xuj	旭
xujo	旭
xuk	嘘
xukl	勖
xuky	吁
xum	栩
xumo	糈
xumx	栩
xun	婿
xunx	絮
xuo	煦
xuoh	煦
xuok	昫
xuol	勖
xuoy	盱
xup	须
xupn	媭
xupr	须
xur	叙
xury	叙
xus	续
xusd	续
xuse	𦈡
xusk	矞
xuso	绪
xut	墟
xutl	垿
xuty	圩
xuv	胥
xuvo	胥
xuw	畜
xuwa	戌
xuwr	顼
xuwx	珝
xux	恤
xuy	许
xuye	需
xuyk	酗
xuyo	谞
xuyw	许
xuyx	诩
xx	下
xxa	夏
xxab	下
xxaw	夏
xxb	瘕
xxe	峡
xxej	峡
xxf	罅
xxh	黠
xxi	虾
xxik	辖
xxiw	厦
xxix	虾
xxk	吓
xxkj	匣
xxkj	呷
xxkx	吓
xxmj	柙
xxo	瞎
xxok	瞎
xxoy	暇
xxq	狭
xxqj	狎
xxr	侠
xxrj	侠
xxu	硖
xxv	叚
xxw	瑕
xxwy	瑕
xxy	霞
xxz	遐
xxzy	遐
xya	鲟
xyac	鲟
xyb	旬
xybe	郇
xybo	窨
xyc	薰
xycc	荨
xych	薰
xyco	荀
xycu	蕈
xyd	殉
xydc	浔
xydo	洵
xydu	汛
xydw	浚
xye	寻
xyec	寻
xyee	𬩽
xyeo	峋
xyi	循
xyio	徇
xyiu	蟫
xyk	勋
xykb	噀
xykl	勋
xym	驯
xymo	栒
xyo	曛
xyoh	曛
xyp	熏
xyph	熏
xyq	獯
xyqh	獯
xys	𬘓
xysb	巽
xysh	𫄸
xyt	埙
xytr	埙
xyw	珣
xywc	𬍤
xywo	珣
xyx	恂
xyxo	恂
xyy	讯
xyy	醺
xyyi	训
xyyo	询
xyyu	讯
xyz	迅
xyzv	巡
xyzx	逊
y	一
ya	亚
yaa	牙
yaap	牙
yaay	亚
yab	丫
yabl	丫
yac	芽
yacy	芽
yad	涯
yadt	涯
yae	崖
yaet	崖
yaey	岈
yaf	押
yafj	押
yafn	揠
yai	压
yai	衙
yaid	压
yaiv	轧
yaiy	蚜
yaj	鸭
yajn	鸭
yak	呀
yak	吖
yaky	哑
yam	桠
yamy	桠
yan	娅
yank	姶
yany	娅
yao	睚
yaot	睚
yaq	氩
yaqd	猰
yaqy	氩
yar	伢
yary	伢
yat	垭
yatt	堐
yaty	垭
yau	砑
yauv	碣
yauy	砑
yaw	琊
yawe	琊
yawy	玡
yay	雅
yay	讶
yayf	雅
yayn	鸦
yaz	迓
yazy	迓
yb	因
yb	隐
ybae	䲟
ybb	瘾
ybbb	寅
ybbo	窨
ybbx	瘾
ybc	荫
ybcd	茵
ybce	茚
ybco	荫
ybd	淫
ybdd	洇
ybdr	淫
ybdy	溵
ybe	阴
ybej	崟
ybeo	阴
ybex	隐
ybg	引
ybi	蚓
ybj	银
ybjd	铟
ybjg	银
ybk	吟
ybkk	嚚
ybkl	吲
ybko	喑
ybkv	吟
ybl	音
yblo	音
yblx	慭
ybm	訚
ybmk	訚
ybmt	𬮱
ybn	姻
ybnd	姻
ybne	鄞
ybp	印
ybpe	印
ybpt	禋
ybpv	胤
ybpy	殷
ybq	狺
ybqd	氤
ybsb	𬙂
ybsd	𬘡
ybt	垠
ybtg	垠
ybtj	圻
ybtt	堙
ybug	硍
ybur	饮
ybv	尹
ybv	龈
ybvp	尹
ybx	夤
ybxo	愔
ybxr	歅
yby	霪
yc	要
yca	尧
ycaf	鳐
ycaw	尧
ycb	窑
ycba	疟
ycbf	窑
ycbl	窈
ycbo	窅
ycc	药
yccu	药
ycdw	滧
yce	崾
yced	隃
ycen	崾
ycew	峣
ycf	摇
ycg	靿
ycgl	靿
yci	徭
ycif	徭
ycik	轺
ycj	钥
ycjd	铫
ycjo	钥
yck	咬
yckx	咬
ycky	吆
ycm	杳
ycn	妖
ycnd	姚
ycnf	媱
ycny	妖
yco	腰
ycof	曜
ycon	腰
ycp	夭
ycpd	乐
ycpj	舀
ycpn	鹞
ycpx	繇
ycqf	猺
ycr	侥
ycrw	侥
ycs	约
yctt	垚
ycv	幺
ycvs	幺
ycw	瑶
ycwd	珧
ycx	耀
ycxf	耀
ycxo	肴
ycxx	爻
ycy	谣
ycyf	谣
ycz	邀
yczf	遥
yczw	邀
ye	也
ye	野
yea	页
year	页
yeb	爷
yebe	爷
yed	液
yedk	冶
yedn	液
yee	耶
yeee	耶
yef	揶
yefe	揶
yefn	掖
yeh	烨
yei	靥
yeim	靥
yej	铘
yeje	铘
yek	叶
yeka	噎
yekd	咽
yekl	嘢
yeku	叶
yekv	喝
yel	业
yela	业
yell	野
yelp	曳
yem	椰
yeme	椰
yeo	腋
yeon	腋
yeou	晔
yere	倻
yetv	堨
yeu	射
yeuc	射
yeum	馌
yev	也
yevv	也
yew	夜
yewn	夜
yey	邺
yeyv	谒
yh	样
yh	杨
yhb	痒
yhbl	羊
yhbp	疡
yhd	洋
yhd	漾
yhdy	泱
yhdy	殃
yhe	阳
yheo	阳
yhf	扬
yhfp	扬
yhg	鞅
yhgy	鞅
yhh	秧
yhhp	炀
yhhy	烊
yhi	徉
yhj	飏
yhjp	钖
yhk	咉
yhky	咉
yhl	央
yhm	杨
yhmy	样
yho	旸
yhop	旸
yhpe	卬
yhq	氧
yhr	仰
yhre	仰
yhry	佯
yhty	垟
yhw	玚
yhwp	玚
yhx	怏
yhxy	怏
yhy	养
yhyl	养
yhyn	鸯
yhyx	恙
yhyy	羕
yi	以
yia	夷
yiaa	一
yiad	弋
yian	夷
yib	益
yib	肄
yibl	宧
yibq	宜
yibr	疑
yibt	瘗
yibx	癔
yiby	疫
yiby	痍
yic	艺
yicn	𬟁
yicr	苡
yicv	艺
yicx	薏
yicx	艾
yicy	荑
yid	溢
yid	沂
yida	殪
yidb	浥
yidk	漪
yidx	义
yie	屹
yiel	峄
yier	嶷
yif	抑
yifb	挹
yife	揖
yifk	旖
yigb	廙
yih	移
yihb	熠
yihx	黟
yii	役
yii	颐
yiib	蛇
yiim	螠
yiiu	轶
yiiw	蜴
yiiy	蚁
yij	镒
yijv	钇
yijy	铱
yik	咦
yik	贻
yikb	邑
yikm	嗌
yikr	颐
yiku	医
yikv	呓
yikx	翳
yikx	噫
yiky	咿
yil	毅
yil	翊
yilx	意
yim	椅
yiml	驿
yimy	杙
yin	姨
yinx	嫕
yiny	姨
yio	易
yiok	眙
yiou	昳
yiow	易
yiox	臆
yioy	胰
yip	祎
yipn	乂
yipw	祎
yiq	猗
yir	依
yir	伊
yird	㑊
yirk	倚
yirl	食
yiro	佾
yirq	仡
yiru	佚
yirv	亿
yiry	仪
yis	异
yisc	异
yisl	绎
yism	缢
yisu	矣
yisx	𫄷
yit	圯
yitw	埸
yiu	壹
yiuc	射
yiuk	饴
yium	尾
yiux	懿
yiv	已
yiv	彝
yivk	𬺈
yivr	以
yivv	乙
yivx	簃
yivy	舣
yiw	亦
yiw	奕
yiwc	弈
yiwk	裔
yiwy	衣
yix	翼
yix	怡
yixc	羿
yixd	刈
yixl	翌
yixl	怿
yixv	忆
yiy	议
yiyk	诒
yiyl	译
yiyo	诣
yiyq	谊
yiyy	酏
yiz	遗
yizd	逸
yizr	遗
yizy	迤
yj	眼
yj	严
yjb	宴
yjbg	戭
yjbn	宴
yjc	芫
yjce	芫
yjd	演
yjd	淹
yjdb	滟
yjdc	渰
yjdd	奄
yjde	沇
yjdh	漹
yjdk	沿
yjdt	湮
yje	岩
yjed	崦
yjeq	𪩘
yjeu	岩
yjf	艳
yjfb	艳
yjfd	掩
yjh	烟
yjhh	炎
yjhh	焱
yjhj	焰
yjhw	甗
yji	颜
yji	衍
yjif	雁
yjig	魇
yjil	餍
yjin	蝘
yjip	彦
yjiq	厌
yjir	赝
yjiz	蜒
yjj	鼹
yjk	咽
yjkd	咽
yjkk	唁
yjkn	𬸘
yjkz	觃
yjlt	䶮
yjm	验
yjm	檐
yjma	验
yjmd	阉
yjmh	棪
yjmj	阎
yjms	闫
yjmz	梴
yjn	燕
yjnh	嫣
yjnk	妍
yjo	腌
yjod	胭
yjog	眼
yjon	晏
yjp	殷
yjpy	殷
yjr	俨
yjrc	弇
yjrn	偃
yjs	罨
yjsd	罨
yjt	盐
yjth	墕
yjtm	盐
yjtn	堰
yju	研
yjue	砚
yjuk	研
yjv	筵
yjv	鄢
yjvh	焉
yjw	言
yjw	琰
yjwe	兖
yjwk	言
yjx	恹
yjy	严
yjyp	谚
yjyy	酽
yjz	延
yk	应
ykb	颖
ykbn	瘿
ykbr	颍
ykc	英
ykc	莹
ykcf	䓨
ykch	荧
ykci	萤
ykcj	蓥
ykck	营
ykcn	莺
ykct	茔
ykcu	荥
ykcx	萦
ykd	瀛
ykdf	瀛
ykdm	溁
ykdy	滢
ykf	撄
ykfn	撄
ykg	鹰
ykg	膺
ykga	应
ykgn	鹰
yki	蝇
ykid	蝇
ykk	婴
ykk	鹦
ykke	郢
ykkf	罂
ykkn	嘤
ykm	樱
ykm	楹
ykmn	樱
ykn	盈
yknm	盈
yko	影
ykon	媵
ykop	影
ykoy	映
yks	缨
yksn	缨
yku	硬
ykw	赢
ykw	嬴
ykwn	璎
ykwy	瑛
ykz	迎
ykze	迎
yo	哟
yok	哟
yoko	唷
yoku	哟
yr	元
yr	园
yrb	冤
yrbv	宛
yrc	苑
yrce	芫
yrcv	苑
yrcz	薳
yrd	源
yrd	沅
yrdl	渊
yrdx	源
yrdy	湲
yre	院
yred	鼋
yree	元
yrf	援
yrfu	掾
yrfy	援
yri	原
yrio	蜎
yrix	愿
yriy	辕
yrk	员
yrke	园
yrkr	圆
yrky	圜
yrm	橼
yrmu	橼
yrmx	𫘪
yrn	媛
yrne	妧
yrnx	嫄
yrny	媛
yrp	爰
yrpy	爰
yrq	猿
yrqy	猿
yrs	缘
yrt	袁
yrte	垸
yrtg	垣
yrtx	塬
yrty	袁
yrv	箢
yrw	瑗
yrx	怨
yrx	鸳
yrxo	眢
yrxx	怨
yry	鸢
yryn	鸢
yryx	羱
yrz	远
ys	用
ysa	鳙
ysal	鳙
ysay	鲬
ysb	痈
ysby	痈
ysd	永
ysd	泳
ysdf	澭
ysdn	永
ysdy	涌
ysf	拥
ysfy	拥
ysg	庸
ysge	鄘
yshy	㶲
ysi	蛹
ysj	镛
ysjl	镛
ysk	咏
yskl	用
ysky	喁
ysmy	栐
yso	臃
ysof	臃
ysr	佣
ysry	俑
yss	勇
yssl	勇
yssx	恿
yssy	甬
yst	墉
ystl	墉
ysty	埇
ysv	邕
ysvb	邕
ysw	雍
yswf	雍
yswl	饔
yswt	壅
ysx	慵
ysz	踊
yszy	踊
yt	月
ytd	瀹
ytdc	瀹
ytiw	𫐄
ytj	钺
ytjo	钥
ytk	曰
ytka	月
ytkx	哕
ytm	阅
ytme	阅
ytml	栎
ytmv	樾
yto	刖
ytod	刖
ytp	乐
ytpd	乐
ytpv	粤
ytq	岳
ytqe	岳
ytqn	𬸚
ytr	龠
ytrc	龠
yts	约
ytt	越
yttf	趯
yttv	越
ytvc	籥
ytw	玥
ytwo	玥
ytx	悦
ytxe	悦
yty	说
ytz	跃
ytzy	跃
yu	与
yua	于
yuaa	与
yuad	雨
yual	于
yub	宇
yubd	瘀
yubg	窳
yubn	鹆
yubr	欲
yuby	寓
yuc	芋
yuc	萸
yucc	蔚
yucd	薁
yucr	蓣
yud	鱼
yud	浴
yuda	渔
yudd	渝
yudd	淤
yudo	汩
yudr	滪
yudu	㳚
yue	屿
yued	嵛
yuek	峪
yuey	隅
yuf	揄
yufd	於
yug	鬻
yugl	鬻
yugy	庾
yuh	煜
yuhk	燏
yuht	虞
yui	御
yuia	蜮
yuie	御
yuj	钰
yujc	舁
yujy	钰
yuk	喻
yuk	圄
yukd	喻
yukg	圉
yuky	吁
yul	禺
yum	驭
yuma	阈
yumd	榆
yumy	驭
yun	娱
yunl	妤
yunt	娱
yunx	妪
yuo	昱
yuol	昱
yuoy	腴
yup	禹
yupb	舆
yupd	禹
yupk	裕
yupn	臾
yupv	毓
yuq	狱
yuqd	㺄
yuqh	狳
yur	余
yur	觎
yurd	俞
yurh	余
yurt	俣
yurx	愈
yus	预
yus	鹬
yusl	予
yusn	豫
yut	域
yuta	域
yuto	堉
yutq	圫
yuu	郁
yuuc	尉
yuuy	饫
yuv	聿
yuvk	龉
yuvy	竽
yuw	玉
yuwd	瑜
yuwo	育
yux	羽
yuxd	愉
yuxk	誉
yuy	语
yuyd	谕
yuyk	雩
yuym	盂
yuyr	欤
yuyx	愚
yuyy	谀
yuz	遇
yuzd	逾
yuzk	遹
yuzy	迂
yy	云
yyb	匀
yybe	郓
yyc	芸
yycm	蕴
yycs	芸
yycv	菀
yyd	殒
yye	陨
yyer	陨
yyes	云
yyhm	煴
yyk	郧
yyke	郧
yyl	韵
yyld	韵
yyls	耘
yyn	孕
yyns	妘
yynz	孕
yyo	晕
yyod	昀
yyoi	晕
yyq	氲
yyqe	狁
yyqm	氲
yys	允
yys	纭
yysm	缊
yytj	鋆
yyu	熨
yyv	筠
yyw	韫
yywr	赟
yyx	愠
yyxi	恽
yyxm	愠
yyy	酝
yyz	运
yyzs	运
yz	有
yz	友
yza	鱿
yzaa	酉
yzay	鲉
yzb	疣
yzbo	宥
yzbq	猷
yzby	疣
yzc	莜
yzcn	莠
yzcw	莜
yzcy	莸
yzd	游
yzdy	油
yzdz	游
yze	幽
yzey	幽
yzgb	麀
yzh	黝
yzhl	黝
yzi	蝣
yzil	蚴
yzj	铀
yzjo	铕
yzjy	鼬
yzk	呦
yzkl	呦
yzko	囿
yzl	由
yzla	卣
yzlw	耰
yzm	柚
yzmh	槱
yzmy	柚
yzp	祐
yzpf	牖
yzpx	繇
yzpy	釉
yzq	犹
yzqy	犹
yzr	优
yzrk	佑
yzro	侑
yzrw	攸
yzrx	悠
yzry	优
yzu	右
yzud	尤
yzuk	右
yzuy	友
yzv	又
yzvn	又
yzx	忧
yzxa	酉
yzxy	忧
yzy	邮
yzyd	尤
yzye	邮
yzyl	幼
yzyn	诱
z	在
z	子
za	杂
zaf	扎
zafv	扎
zafx	拶
zaj	杂
zajm	杂
zak	咋
zak	咂
zakj	匝
zakv	咋
zakz	咱
zao	臜
zaor	臜
zau	砸
zauj	砸
zc	早
zc	遭
zca	枣
zcad	枣
zcb	皂
zcbq	皂
zcc	藻
zccm	藻
zcd	澡
zch	灶
zchm	燥
zcht	灶
zci	蚤
zcii	蚤
zck	噪
zckm	噪
zckq	唣
zcm	糟
zcmo	糟
zco	早
zcou	早
zcum	𥖨
zcvz	簉
zcw	璪
zcwm	璪
zcxz	慥
zcy	凿
zcyk	凿
zcz	造
zczk	造
zczm	躁
zczo	遭
zd	再
zda	再
zdar	再
zdb	灾
zdbh	灾
zdbu	宰
zde	崽
zdex	崽
zdr	仔
zdrz	仔
zdu	载
zduk	哉
zdum	栽
zdut	在
zdv	甾
zdvt	甾
ze	则
zed	泽
zedl	泽
zef	责
zefl	择
zefr	责
zei	仄
zeir	赜
zej	帻
zejr	帻
zek	啧
zekd	则
zekr	赜
zekv	咋
zeo	昃
zeor	昃
zev	笮
zevr	箦
zevv	舴
zez	迮
zezv	迮
zf	怎
zfv	怎
zfvx	怎
zfy	谮
zfyo	谮
zg	增
zgb	曾
zgbe	鄫
zgbo	曾
zgbw	甑
zgj	锃
zgjw	锃
zgk	赠
zgko	赠
zgs	缯
zgso	罾
zgsx	综
zgto	增
zguo	矰
zgx	憎
zgxo	憎
zh	藏
zha	臧
zhad	臧
zhc	葬
zhcc	葬
zhci	藏
zhk	赃
zhkt	赃
zhm	驵
zhmq	驵
zho	脏
zhot	脏
zhp	奘
zhpd	奘
zhpy	牂
zhv	奘
zhvd	奘
zhw	臧
zhwi	臧
zi	字
zia	鲻
ziab	髭
ziat	鲻
zib	兹
ziby	兹
zibz	孳
zic	茈
zicb	茈
zicv	鼒
zid	资
zid	渍
zidk	咨
zidn	姿
zidt	淄
zidu	滓
zidx	恣
zidy	滋
zie	嵫
ziey	嵫
zih	秭
zihp	秭
zii	辎
ziit	辎
zij	锱
zijy	镃
zik	吱
zikb	呲
ziky	嗞
zil	耔
zilz	耔
zim	梓
zimz	籽
zin	姊
zinp	姊
zio	眦
ziob	眦
zip	自
zipo	自
zir	仔
zirz	仔
zis	缁
zist	缁
zit	趑
zitr	趑
ziv	子
ziva	子
zivb	龇
zivk	訾
zivp	笫
zivx	紫
zivy	觜
ziy	鄑
ziz	孜
zizw	孜
zizz	孖
zjbr	寁
zjf	攒
zjfr	攒
zjfx	拶
zji	暂
zjij	錾
zjio	暂
zjk	咱
zjm	糌
zjmo	糌
zjn	赞
zjne	酂
zjnr	赞
zjt	趱
zjtr	趱
zjv	簪
zjvo	簪
zjw	瓒
zjwo	昝
zjwr	瓒
zo	做
zoe	阼
zoev	岞
zof	撮
zofu	捽
zofy	撮
zog	座
zogt	座
zok	嘬
zokt	唑
zoky	嘬
zom	柞
zomv	柞
zoo	昨
zoov	胙
zop	祚
zopv	祚
zor	作
zorg	佐
zort	坐
zorv	作
zorw	做
zou	左
zov	笮
zovv	笮
zow	琢
zown	琢
zox	怍
zoxv	怍
zoy	酢
zoyv	酢
zrf	攥
zrfx	攥
zrj	钻
zrk	赚
zrs	缵
zrsr	缵
zrv	纂
zrvx	纂
zrz	躜
zrzr	躜
zs	总
zsa	鬃
zsaw	鬷
zsax	鬃
zsb	宗
zsbr	疭
zsh	熜
zshx	熜
zsm	棕
zsmr	枞
zsmx	粽
zso	腙
zsox	腙
zsr	偬
zsrx	倧
zss	纵
zssx	综
zsz	踪
zszx	踪
zu	组
zuc	菹
zucq	菹
zue	阻
zueq	阻
zueu	崒
zuf	族
zuh	租
zuhq	租
zuj	镞
zuk	足
zukr	足
zup	祖
zupq	祖
zur	俎
zurq	俎
zus	组
zusq	组
zuw	卒
zuwq	珇
zuy	诅
zuyq	诅
zv	最
zvc	蕞
zvcy	蕞
zvk	嘴
zvky	嘴
zvmn	槜
zvo	最
zvoy	最
zvs	罪
zvsf	罪
zvv	觜
zvvy	觜
zvy	醉
zw	贼
zwa	鲗
zwad	鲗
zwk	贼
zwku	贼
zya	鳟
zyac	鳟
zyb	尊
zybc	尊
zye	嶟
zyec	嶟
zyf	撙
zyfc	撙
zyjc	𨱔
zyk	噂
zykc	噂
zym	樽
zymc	樽
zyrc	僔
zyz	遵
zyzc	遵
zz	走
zz	揍
zza	鲰
zzay	鲰
zzd	邹
zze	陬
zzee	鄹
zzey	陬
zzf	奏
zzft	揍
zzm	驺
zzme	驺
zztr	走
zzy	诹